hour,nodes,edges,replies,retweets,quotes,interactions,independent,neutral,positive,negative,ntweets,per_neutral,per_positive,per_negative,indeg_pos,indeg_neg,indeg_neu
2016-05-12_13,64,28,2,25,1,28,15,18,19,6,43,0.4186046511627907,0.4418604651162791,0.13953488372093023,8.0,1.0,0.0
2016-05-12_14,648,410,41,340,17,398,184,240,200,142,582,0.41237113402061853,0.3436426116838488,0.24398625429553264,76.0,15.0,19.0
2016-05-12_15,1348,921,65,480,15,560,236,327,274,195,796,0.4108040201005025,0.3442211055276382,0.2449748743718593,134.0,33.0,75.0
2016-05-12_16,2547,1998,121,1004,43,1168,423,577,632,382,1591,0.3626649905719673,0.39723444374607164,0.24010056568196103,333.0,59.0,176.0
2016-05-12_17,3671,3201,136,1108,42,1286,384,578,690,402,1670,0.3461077844311377,0.41317365269461076,0.2407185628742515,559.0,165.0,303.0
2016-05-12_18,4662,4356,143,1102,49,1294,305,525,671,403,1599,0.32833020637898686,0.41963727329580985,0.25203252032520324,794.0,307.0,340.0
2016-05-12_19,5458,5333,132,918,36,1086,301,501,618,268,1387,0.361211247296323,0.44556596971881757,0.1932227829848594,961.0,397.0,370.0
2016-05-12_20,6225,6351,124,970,37,1131,310,491,724,226,1441,0.34073560027758504,0.5024288688410826,0.1568355308813324,1266.0,457.0,397.0
2016-05-12_21,7149,7537,142,1157,44,1343,405,548,836,364,1748,0.3135011441647597,0.4782608695652174,0.20823798627002288,1556.0,569.0,492.0
2016-05-12_22,7910,8553,134,989,54,1177,409,524,794,268,1586,0.33039092055485497,0.5006305170239597,0.16897856242118536,1840.0,594.0,659.0
2016-05-12_23,8209,9003,53,482,18,553,145,254,328,116,698,0.3638968481375358,0.4699140401146132,0.166189111747851,1996.0,607.0,714.0
2016-05-13_00,8387,9201,24,206,5,235,123,154,125,79,358,0.4301675977653631,0.34916201117318435,0.2206703910614525,2055.0,613.0,753.0
2016-05-13_01,8486,9348,26,154,1,181,39,80,91,49,220,0.36363636363636365,0.41363636363636364,0.22272727272727272,2083.0,617.0,779.0
2016-05-13_02,8582,9455,11,110,3,124,43,56,73,38,167,0.33532934131736525,0.437125748502994,0.2275449101796407,2106.0,625.0,805.0
2016-05-13_03,8624,9513,2,63,1,66,20,25,39,22,86,0.29069767441860467,0.45348837209302323,0.2558139534883721,2121.0,636.0,811.0
2016-05-13_04,8727,9640,9,142,1,152,70,48,105,69,222,0.21621621621621623,0.47297297297297297,0.3108108108108108,2162.0,647.0,830.0
2016-05-13_05,9069,10053,20,432,7,459,146,164,203,238,605,0.27107438016528923,0.33553719008264465,0.3933884297520661,2217.0,740.0,908.0
2016-05-13_06,9612,10761,66,731,24,821,318,349,511,279,1139,0.3064091308165057,0.4486391571553995,0.24495171202809482,2397.0,801.0,976.0
2016-05-13_07,10363,11756,114,992,60,1166,444,563,662,385,1610,0.34968944099378885,0.4111801242236025,0.2391304347826087,2661.0,882.0,1060.0
2016-05-13_08,11248,12922,166,1146,69,1381,483,636,737,491,1864,0.34120171673819744,0.3953862660944206,0.263412017167382,2901.0,987.0,1162.0
2016-05-13_09,12308,14230,181,1253,65,1499,745,594,715,935,2244,0.2647058823529412,0.31862745098039214,0.4166666666666667,3137.0,1068.0,1337.0
2016-05-13_10,13217,15273,150,986,61,1197,627,609,558,657,1824,0.3338815789473684,0.3059210526315789,0.36019736842105265,3300.0,1170.0,1454.0
2016-05-13_11,14117,16492,192,1158,72,1422,568,607,843,540,1990,0.3050251256281407,0.4236180904522613,0.271356783919598,3627.0,1252.0,1531.0
2016-05-13_12,15010,17711,163,1270,50,1483,568,640,807,604,2051,0.3120429058995612,0.39346660165772795,0.29449049244271086,3961.0,1304.0,1658.0
2016-05-13_13,15691,18726,122,1065,46,1233,411,602,709,333,1644,0.3661800486618005,0.43126520681265207,0.20255474452554745,4273.0,1348.0,1753.0
2016-05-13_14,16233,19507,135,780,36,951,387,502,585,251,1338,0.375186846038864,0.437219730941704,0.187593423019432,4506.0,1383.0,1796.0
2016-05-13_15,16912,20678,160,1289,50,1499,416,627,938,350,1915,0.3274151436031332,0.48981723237597913,0.18276762402088773,4996.0,1460.0,1870.0
2016-05-13_16,17581,21834,150,1216,49,1415,350,520,864,381,1765,0.29461756373937675,0.48951841359773374,0.2158640226628895,5357.0,1552.0,1914.0
2016-05-13_17,18176,22971,182,1189,54,1425,363,529,903,356,1788,0.2958612975391499,0.5050335570469798,0.19910514541387025,5749.0,1653.0,1986.0
2016-05-13_18,18761,24030,128,1143,40,1311,307,511,762,345,1618,0.3158220024721879,0.47095179233621753,0.21322620519159455,6048.0,1760.0,2097.0
2016-05-13_19,19373,25054,139,1128,28,1295,327,460,838,324,1622,0.2836004932182491,0.5166461159062885,0.1997533908754624,6347.0,1844.0,2189.0
2016-05-13_20,19856,25935,129,993,36,1158,247,481,662,262,1405,0.3423487544483986,0.4711743772241993,0.18647686832740212,6634.0,1900.0,2288.0
2016-05-13_21,20299,26763,133,833,41,1007,279,450,601,235,1286,0.3499222395023328,0.46734059097978226,0.1827371695178849,6861.0,1939.0,2351.0
2016-05-13_22,20598,27435,79,734,48,861,135,322,489,185,996,0.3232931726907631,0.49096385542168675,0.1857429718875502,7089.0,1966.0,2399.0
2016-05-13_23,20745,27753,47,372,12,431,98,149,277,103,529,0.28166351606805295,0.5236294896030246,0.1947069943289225,7234.0,1978.0,2426.0
2016-05-14_00,20823,27951,21,231,9,261,64,95,184,46,325,0.2923076923076923,0.5661538461538461,0.14153846153846153,7321.0,1984.0,2439.0
2016-05-14_01,20871,28051,10,106,4,120,27,52,76,19,147,0.35374149659863946,0.5170068027210885,0.1292517006802721,7360.0,1985.0,2443.0
2016-05-14_02,20903,28144,0,109,0,109,22,24,87,20,131,0.183206106870229,0.6641221374045801,0.15267175572519084,7400.0,1986.0,2446.0
2016-05-14_03,20936,28219,3,90,1,94,20,38,63,13,114,0.3333333333333333,0.5526315789473685,0.11403508771929824,7428.0,1988.0,2448.0
2016-05-14_04,20994,28330,9,134,1,144,47,55,102,34,191,0.2879581151832461,0.5340314136125655,0.17801047120418848,7475.0,1991.0,2454.0
2016-05-14_05,21093,28530,22,223,9,254,129,103,208,72,383,0.2689295039164491,0.5430809399477807,0.18798955613577023,7543.0,1999.0,2463.0
2016-05-14_06,21372,29077,43,590,24,657,191,227,452,169,848,0.267688679245283,0.5330188679245284,0.19929245283018868,7712.0,2033.0,2530.0
2016-05-14_07,21783,29937,93,951,28,1072,302,388,762,224,1374,0.2823871906841339,0.5545851528384279,0.16302765647743814,8019.0,2071.0,2585.0
2016-05-14_08,22253,30832,113,921,52,1086,321,418,741,248,1407,0.2970859985785359,0.5266524520255863,0.17626154939587776,8277.0,2126.0,2654.0
2016-05-14_09,22753,31869,133,1146,82,1361,352,507,959,247,1713,0.29597197898423816,0.5598365440747227,0.14419147694103912,8654.0,2185.0,2767.0
2016-05-14_10,23200,32814,111,992,60,1163,325,499,687,302,1488,0.3353494623655914,0.46169354838709675,0.20295698924731181,8932.0,2272.0,2848.0
2016-05-14_11,23682,33719,117,1001,46,1164,311,430,820,225,1475,0.29152542372881357,0.5559322033898305,0.15254237288135594,9253.0,2321.0,2897.0
2016-05-14_12,24086,34634,133,926,59,1118,266,439,673,272,1384,0.3171965317919075,0.48627167630057805,0.19653179190751446,9480.0,2340.0,3030.0
2016-05-14_13,24451,35374,110,740,46,896,231,333,566,228,1127,0.29547471162378,0.5022182786157942,0.2023070097604259,9660.0,2385.0,3087.0
2016-05-14_14,24759,36009,94,693,43,830,212,318,550,174,1042,0.30518234165067176,0.527831094049904,0.16698656429942418,9855.0,2423.0,3146.0
2016-05-14_15,25067,36808,106,864,39,1009,258,418,664,185,1267,0.32991318074191,0.5240726124704025,0.14601420678768745,10095.0,2456.0,3222.0
2016-05-14_16,25403,37620,98,882,33,1013,257,378,692,200,1270,0.29763779527559053,0.5448818897637795,0.15748031496062992,10334.0,2498.0,3299.0
2016-05-14_17,25863,38504,106,961,40,1107,241,495,565,288,1348,0.3672106824925816,0.41913946587537093,0.21364985163204747,10504.0,2645.0,3375.0
2016-05-14_18,26288,39293,119,848,37,1004,240,471,560,213,1244,0.37861736334405144,0.45016077170418006,0.1712218649517685,10704.0,2758.0,3443.0
2016-05-14_19,27255,40249,150,938,47,1135,676,590,1002,219,1811,0.32578685808945335,0.5532854776366648,0.12092766427388184,10887.0,2853.0,3512.0
2016-05-14_20,28704,41521,231,1138,59,1428,813,796,1015,430,2241,0.35519857206604194,0.45292280232039267,0.19187862561356536,11047.0,2913.0,3567.0
2016-05-14_21,29823,42640,211,1010,78,1299,698,734,1016,247,1997,0.3675513269904857,0.5087631447170756,0.12368552829243866,11283.0,3008.0,3616.0
2016-05-14_22,31554,43914,240,1154,34,1428,1306,744,1723,267,2734,0.2721287490855889,0.6302121433796635,0.09765910753474762,11445.0,3072.0,3678.0
2016-05-14_23,31880,44416,91,496,19,606,165,216,454,101,771,0.2801556420233463,0.5888456549935149,0.1309987029831388,11576.0,3087.0,3694.0
2016-05-15_00,31992,44630,37,232,8,277,68,104,202,39,345,0.30144927536231886,0.5855072463768116,0.11304347826086956,11640.0,3091.0,3701.0
2016-05-15_01,32041,44723,12,111,3,126,32,44,96,18,158,0.27848101265822783,0.6075949367088608,0.11392405063291139,11675.0,3094.0,3709.0
2016-05-15_02,32072,44788,4,71,2,77,11,23,50,15,88,0.26136363636363635,0.5681818181818182,0.17045454545454544,11694.0,3101.0,3715.0
2016-05-15_03,32103,44837,6,56,3,65,24,32,44,13,89,0.3595505617977528,0.4943820224719101,0.14606741573033707,11705.0,3105.0,3717.0
2016-05-15_04,32140,44894,6,62,1,69,43,29,55,28,112,0.25892857142857145,0.49107142857142855,0.25,11730.0,3105.0,3719.0
2016-05-15_05,32216,45031,17,168,4,189,69,66,153,39,258,0.2558139534883721,0.5930232558139535,0.1511627906976744,11785.0,3111.0,3722.0
2016-05-15_06,32423,45349,34,344,22,400,180,150,292,138,580,0.25862068965517243,0.503448275862069,0.23793103448275862,11882.0,3184.0,3742.0
2016-05-15_07,32889,46150,94,840,45,979,353,411,652,269,1332,0.30855855855855857,0.4894894894894895,0.20195195195195195,12035.0,3345.0,3767.0
2016-05-15_08,33620,47498,163,1410,67,1640,604,742,926,576,2244,0.3306595365418895,0.4126559714795009,0.25668449197860965,12290.0,3579.0,3880.0
2016-05-15_09,34301,48814,180,1374,79,1633,486,705,829,585,2119,0.33270410571024067,0.39122227465785747,0.27607361963190186,12611.0,3866.0,3953.0
2016-05-15_10,34970,49991,153,1222,63,1438,556,725,695,574,1994,0.36359077231695086,0.3485456369107322,0.28786359077231694,12827.0,3988.0,4042.0
2016-05-15_11,35421,50904,116,974,64,1154,348,444,663,395,1502,0.2956058588548602,0.4414114513981358,0.262982689747004,13062.0,4054.0,4116.0
2016-05-15_12,35893,51881,150,1015,53,1218,306,528,649,347,1524,0.3464566929133858,0.4258530183727034,0.22769028871391075,13275.0,4209.0,4170.0
2016-05-15_13,36311,52758,108,1003,43,1154,264,540,644,234,1418,0.38081805359661497,0.4541607898448519,0.16502115655853314,13548.0,4378.0,4227.0
2016-05-15_14,36703,53576,108,885,35,1028,238,453,632,181,1266,0.3578199052132701,0.49921011058451814,0.1429699842022117,13785.0,4490.0,4262.0
2016-05-15_15,37086,54424,90,940,43,1073,204,479,538,260,1277,0.375097885669538,0.42129992169146435,0.20360219263899765,14010.0,4667.0,4304.0
2016-05-15_16,37425,55194,98,886,48,1032,219,496,527,228,1251,0.3964828137490008,0.4212629896083134,0.18225419664268586,14249.0,4826.0,4392.0
2016-05-15_17,37771,56025,110,917,52,1079,240,470,627,222,1319,0.35633055344958303,0.47536012130401817,0.1683093252463988,14479.0,4920.0,4470.0
2016-05-15_18,38112,56940,98,1007,52,1157,259,472,720,224,1416,0.3333333333333333,0.5084745762711864,0.15819209039548024,14718.0,4988.0,4541.0
2016-05-15_19,38438,57760,103,889,40,1032,233,439,581,245,1265,0.34703557312252964,0.4592885375494071,0.19367588932806323,14943.0,5038.0,4581.0
2016-05-15_20,38728,58469,77,842,45,964,220,371,583,230,1184,0.31334459459459457,0.49239864864864863,0.19425675675675674,15165.0,5105.0,4605.0
2016-05-15_21,39037,59218,112,832,51,995,223,380,629,209,1218,0.31198686371100165,0.5164203612479474,0.17159277504105092,15435.0,5198.0,4662.0
2016-05-15_22,39255,59773,83,599,36,718,144,258,471,133,862,0.29930394431554525,0.5464037122969838,0.154292343387471,15635.0,5236.0,4692.0
2016-05-15_23,39351,60049,25,346,14,385,77,127,273,62,462,0.2748917748917749,0.5909090909090909,0.1341991341991342,15752.0,5244.0,4704.0
2016-05-16_00,39404,60165,13,151,7,171,39,75,104,31,210,0.35714285714285715,0.49523809523809526,0.14761904761904762,15795.0,5254.0,4716.0
2016-05-16_01,39444,60236,5,87,3,95,42,50,73,14,137,0.36496350364963503,0.5328467153284672,0.10218978102189781,15824.0,5260.0,4719.0
2016-05-16_02,39470,60297,2,88,0,90,37,24,49,54,127,0.1889763779527559,0.3858267716535433,0.4251968503937008,15845.0,5266.0,4739.0
2016-05-16_03,39831,60671,0,392,0,392,18,23,361,26,410,0.05609756097560976,0.8804878048780488,0.06341463414634146,15852.0,5271.0,4746.0
2016-05-16_04,39866,60743,4,103,1,108,41,36,90,23,149,0.24161073825503357,0.6040268456375839,0.15436241610738255,15879.0,5277.0,4751.0
2016-05-16_05,39986,61021,24,352,7,383,142,146,235,144,525,0.2780952380952381,0.44761904761904764,0.2742857142857143,15985.0,5289.0,4785.0
2016-05-16_06,40307,61702,66,871,27,964,358,402,649,271,1322,0.3040847201210287,0.4909228441754917,0.20499243570347958,16225.0,5343.0,4910.0
2016-05-16_07,40745,62610,132,1081,41,1254,409,546,821,296,1663,0.32832230907997595,0.4936861094407697,0.17799158147925437,16544.0,5396.0,5053.0
2016-05-16_08,41302,63687,110,1239,50,1399,475,648,876,350,1874,0.3457844183564568,0.46744930629669157,0.18676627534685167,16838.0,5443.0,5189.0
2016-05-16_09,41862,64767,128,1179,72,1379,498,699,769,409,1877,0.3724027703782632,0.4096963239211508,0.21790090570058604,17119.0,5493.0,5324.0
2016-05-16_10,42349,65676,131,966,60,1157,482,534,668,437,1639,0.32580841976815134,0.40756558877364246,0.2666259914582062,17393.0,5533.0,5461.0
2016-05-16_11,42896,66648,99,1113,78,1290,486,662,662,452,1776,0.37274774774774777,0.37274774774774777,0.2545045045045045,17706.0,5618.0,5545.0
2016-05-16_12,43336,67585,95,1060,73,1228,429,592,736,329,1657,0.35727217863608934,0.44417622208811103,0.19855159927579963,17981.0,5700.0,5615.0
2016-05-16_13,43760,68397,102,946,58,1106,338,479,673,292,1444,0.3317174515235457,0.4660664819944598,0.20221606648199447,18224.0,5774.0,5693.0
2016-05-16_14,44221,69234,94,957,50,1101,383,640,509,335,1484,0.431266846361186,0.34299191374663074,0.22574123989218328,18384.0,5915.0,5789.0
2016-05-16_15,44718,70218,111,1090,48,1249,426,779,619,277,1675,0.46507462686567164,0.36955223880597016,0.1653731343283582,18578.0,5997.0,5875.0
2016-05-16_16,45152,71168,133,1084,54,1271,433,811,606,287,1704,0.47593896713615025,0.35563380281690143,0.16842723004694835,18826.0,6068.0,5969.0
2016-05-16_17,45596,72127,138,1054,45,1237,458,737,673,285,1695,0.43480825958702063,0.39705014749262535,0.168141592920354,19027.0,6172.0,6054.0
2016-05-16_18,46002,73045,130,952,50,1132,366,682,560,256,1498,0.4552736982643525,0.37383177570093457,0.17089452603471295,19152.0,6326.0,6117.0
2016-05-16_19,46399,73975,129,1084,59,1272,328,644,735,221,1600,0.4025,0.459375,0.138125,19408.0,6410.0,6163.0
2016-05-16_20,46770,74876,120,1054,53,1227,257,581,664,239,1484,0.3915094339622642,0.4474393530997305,0.1610512129380054,19652.0,6463.0,6233.0
2016-05-16_21,47184,75827,126,1052,54,1232,292,619,696,209,1524,0.4061679790026247,0.4566929133858268,0.13713910761154854,19837.0,6509.0,6331.0
2016-05-16_22,47436,76465,82,691,38,811,184,416,415,164,995,0.41809045226130653,0.41708542713567837,0.16482412060301507,19969.0,6580.0,6437.0
2016-05-16_23,47526,76778,45,378,21,444,122,232,271,63,566,0.4098939929328622,0.4787985865724382,0.11130742049469965,20116.0,6619.0,6479.0
2016-05-17_00,47608,76959,19,213,6,238,143,115,138,128,381,0.30183727034120733,0.36220472440944884,0.3359580052493438,20178.0,6630.0,6519.0
2016-05-17_01,47636,77028,10,84,2,96,57,52,66,35,153,0.33986928104575165,0.43137254901960786,0.22875816993464052,20196.0,6635.0,6528.0
2016-05-17_02,47664,77084,1,76,2,79,33,42,50,20,112,0.375,0.44642857142857145,0.17857142857142858,20218.0,6638.0,6538.0
2016-05-17_03,47696,77134,4,66,1,71,24,25,36,34,95,0.2631578947368421,0.37894736842105264,0.35789473684210527,20238.0,6641.0,6554.0
2016-05-17_04,47740,77235,4,129,6,139,51,69,83,38,190,0.3631578947368421,0.4368421052631579,0.2,20265.0,6645.0,6569.0
2016-05-17_05,47852,77505,15,328,10,353,117,134,225,111,470,0.2851063829787234,0.4787234042553192,0.23617021276595745,20330.0,6673.0,6615.0
2016-05-17_06,48189,78221,69,896,32,997,341,587,551,200,1338,0.43871449925261585,0.4118086696562033,0.14947683109118087,20575.0,6735.0,6672.0
2016-05-17_07,48632,79069,108,1032,49,1189,453,618,766,258,1642,0.3763702801461632,0.46650426309378806,0.15712545676004872,20854.0,6815.0,6751.0
2016-05-17_08,49184,80084,101,1187,51,1339,518,735,742,380,1857,0.39579967689822293,0.39956919763058696,0.20463112547119008,21133.0,6905.0,6854.0
2016-05-17_09,49651,80979,112,1056,60,1228,486,703,670,341,1714,0.41015169194865814,0.3908984830805134,0.19894982497082847,21421.0,6951.0,6975.0
2016-05-17_10,50191,81892,140,1002,67,1209,495,844,523,337,1704,0.4953051643192488,0.306924882629108,0.1977699530516432,21615.0,7035.0,7177.0
2016-05-17_11,50750,83004,178,1224,69,1471,507,800,760,418,1978,0.4044489383215369,0.38422649140546006,0.21132457027300303,21865.0,7147.0,7325.0
2016-05-17_12,51280,84026,164,1111,42,1317,509,766,701,359,1826,0.4194961664841183,0.3838992332968237,0.19660460021905804,22083.0,7235.0,7437.0
2016-05-17_13,51847,85036,165,1160,77,1402,503,847,717,341,1905,0.44461942257217846,0.3763779527559055,0.17900262467191602,22362.0,7317.0,7665.0
2016-05-17_14,52336,85966,134,1058,63,1255,483,818,583,337,1738,0.4706559263521289,0.33544303797468356,0.19390103567318756,22578.0,7421.0,7805.0
2016-05-17_15,52795,86858,148,1082,77,1307,508,799,694,322,1815,0.4402203856749311,0.38236914600550964,0.17741046831955923,22902.0,7509.0,7870.0
2016-05-17_16,53423,88172,170,1605,99,1874,575,1090,969,390,2449,0.44507962433646386,0.39567170273581054,0.1592486729277256,23398.0,7671.0,8133.0
2016-05-17_17,53998,89441,215,1465,81,1761,497,1004,868,386,2258,0.4446412754650133,0.38441098317094774,0.17094774136403898,23808.0,7791.0,8297.0
2016-05-17_18,54544,90645,203,1589,74,1866,581,1028,1066,353,2447,0.42010625255414796,0.4356354720065386,0.14425827543931344,24372.0,7889.0,8385.0
2016-05-17_19,55023,91736,159,1417,53,1629,343,733,964,275,1972,0.37170385395537525,0.48884381338742394,0.1394523326572008,24957.0,7976.0,8522.0
2016-05-17_20,55376,92639,138,1121,47,1306,274,577,738,265,1580,0.3651898734177215,0.4670886075949367,0.16772151898734178,25338.0,8044.0,8636.0
2016-05-17_21,55772,93599,127,1179,69,1375,337,715,730,267,1712,0.41764018691588783,0.4264018691588785,0.15595794392523366,25745.0,8124.0,8807.0
2016-05-17_22,56050,94257,85,801,31,917,179,503,446,147,1096,0.45894160583941607,0.40693430656934304,0.13412408759124086,25977.0,8180.0,8981.0
2016-05-17_23,56224,94657,50,475,14,539,119,226,288,144,658,0.3434650455927052,0.4376899696048632,0.2188449848024316,26172.0,8228.0,9015.0
2016-05-18_00,56290,94804,15,184,2,201,60,98,121,42,261,0.37547892720306514,0.46360153256704983,0.16091954022988506,26264.0,8235.0,9028.0
2016-05-18_01,56338,94902,4,123,15,142,52,84,75,35,194,0.4329896907216495,0.3865979381443299,0.18041237113402062,26309.0,8245.0,9041.0
2016-05-18_02,56375,94956,4,89,1,94,23,33,61,23,117,0.28205128205128205,0.5213675213675214,0.19658119658119658,26355.0,8251.0,9050.0
2016-05-18_03,56408,95014,4,75,1,80,17,34,41,22,97,0.35051546391752575,0.422680412371134,0.2268041237113402,26386.0,8257.0,9053.0
2016-05-18_04,56456,95106,7,146,4,157,52,88,85,36,209,0.42105263157894735,0.40669856459330145,0.1722488038277512,26443.0,8261.0,9077.0
2016-05-18_05,56604,95440,27,418,18,463,172,270,246,119,635,0.4251968503937008,0.38740157480314963,0.18740157480314962,26536.0,8312.0,9121.0
2016-05-18_06,56972,96159,76,861,30,967,387,695,432,227,1354,0.5132939438700148,0.3190546528803545,0.16765140324963074,26705.0,8387.0,9168.0
2016-05-18_07,57461,97152,117,1190,52,1359,525,972,599,313,1884,0.5159235668789809,0.3179405520169851,0.16613588110403396,27002.0,8480.0,9263.0
2016-05-18_08,57990,98235,131,1265,52,1448,472,1078,485,357,1920,0.5614583333333333,0.2526041666666667,0.1859375,27247.0,8576.0,9366.0
2016-05-18_09,58450,99042,84,983,47,1114,456,796,444,330,1570,0.5070063694267516,0.28280254777070063,0.21019108280254778,27445.0,8684.0,9432.0
2016-05-18_10,58890,99815,91,915,47,1053,481,811,469,254,1534,0.5286831812255541,0.3057366362451108,0.16558018252933507,27666.0,8752.0,9484.0
2016-05-18_11,59347,100628,126,914,53,1093,483,764,472,340,1576,0.4847715736040609,0.29949238578680204,0.21573604060913706,27874.0,8851.0,9521.0
2016-05-18_12,59714,101324,124,802,44,970,436,628,516,262,1406,0.4466571834992888,0.3669985775248933,0.18634423897581792,28060.0,8881.0,9561.0
2016-05-18_13,60106,102081,127,879,60,1066,413,752,501,226,1479,0.5084516565246788,0.33874239350912777,0.15280594996619337,28243.0,8943.0,9643.0
2016-05-18_14,60494,102784,95,904,43,1042,416,682,498,278,1458,0.46776406035665297,0.34156378600823045,0.1906721536351166,28450.0,8996.0,9743.0
2016-05-18_15,60900,103552,100,949,54,1103,433,722,514,300,1536,0.4700520833333333,0.3346354166666667,0.1953125,28655.0,9099.0,9809.0
2016-05-18_16,61243,104344,91,948,44,1083,399,745,502,235,1482,0.5026990553306343,0.33873144399460187,0.15856950067476383,28840.0,9160.0,9871.0
2016-05-18_17,61641,105252,120,1180,40,1340,413,783,692,278,1753,0.4466628636622932,0.3947518539646321,0.15858528237307473,29134.0,9248.0,9947.0
2016-05-18_18,62004,106128,122,1109,48,1279,339,752,651,215,1618,0.4647713226205192,0.40234857849196537,0.13288009888751545,29385.0,9364.0,9990.0
2016-05-18_19,62309,106853,108,881,38,1027,280,617,478,212,1307,0.4720734506503443,0.3657230298393267,0.162203519510329,29602.0,9414.0,10034.0
2016-05-18_20,62757,107994,129,1294,53,1476,287,717,670,376,1763,0.40669313669880885,0.38003403289846854,0.21327283040272263,29910.0,9693.0,10150.0
2016-05-18_21,63167,109058,119,1210,47,1376,282,698,574,386,1658,0.4209891435464415,0.34620024125452353,0.23281061519903498,30152.0,9841.0,10266.0
2016-05-18_22,63397,109692,78,718,36,832,148,398,389,193,980,0.4061224489795918,0.39693877551020407,0.19693877551020408,30300.0,9919.0,10345.0
2016-05-18_23,63509,110012,33,386,23,442,157,187,310,102,599,0.3121869782971619,0.5175292153589316,0.17028380634390652,30385.0,9959.0,10363.0
2016-05-19_00,63565,110140,17,163,14,194,83,93,143,41,277,0.33574007220216606,0.516245487364621,0.148014440433213,30438.0,9967.0,10384.0
2016-05-19_01,63608,110231,8,103,9,120,42,51,61,50,162,0.3148148148148148,0.3765432098765432,0.30864197530864196,30454.0,9972.0,10410.0
2016-05-19_02,63633,110307,10,87,6,103,30,47,53,33,133,0.3533834586466165,0.39849624060150374,0.24812030075187969,30473.0,9977.0,10416.0
2016-05-19_03,63658,110368,6,82,0,88,40,56,53,19,128,0.4375,0.4140625,0.1484375,30497.0,9983.0,10421.0
2016-05-19_04,63722,110493,5,160,2,167,64,103,89,39,231,0.4458874458874459,0.3852813852813853,0.16883116883116883,30534.0,9991.0,10466.0
2016-05-19_05,63831,110774,29,318,24,371,114,193,179,113,485,0.3979381443298969,0.36907216494845363,0.2329896907216495,30610.0,10017.0,10511.0
2016-05-19_06,64065,111392,66,738,52,856,327,466,446,271,1183,0.39391377852916315,0.37700760777683856,0.22907861369399832,30802.0,10114.0,10560.0
2016-05-19_07,64471,112283,119,1112,48,1279,404,735,638,310,1683,0.43672014260249553,0.3790849673202614,0.18419489007724302,31117.0,10361.0,10612.0
2016-05-19_08,64918,113226,106,1102,37,1245,447,789,599,304,1692,0.46631205673758863,0.3540189125295508,0.17966903073286053,31340.0,10534.0,10655.0
2016-05-19_09,65335,114062,108,958,33,1099,405,772,459,273,1504,0.5132978723404256,0.30518617021276595,0.1815159574468085,31535.0,10624.0,10703.0
2016-05-19_10,65745,114920,140,910,71,1121,411,736,501,295,1532,0.4804177545691906,0.32702349869451697,0.19255874673629242,31735.0,10692.0,10732.0
2016-05-19_11,66126,115700,112,980,42,1134,410,725,589,230,1544,0.469559585492228,0.38147668393782386,0.1489637305699482,31982.0,10765.0,10779.0
2016-05-19_12,66481,116512,96,1096,60,1252,427,759,695,225,1679,0.4520547945205479,0.41393686718284695,0.13400833829660513,32351.0,10822.0,10859.0
2016-05-19_13,66805,117297,94,1036,33,1163,369,665,598,269,1532,0.43407310704960833,0.39033942558746737,0.17558746736292427,32634.0,10858.0,11008.0
2016-05-19_14,67099,118009,91,970,37,1098,389,693,580,214,1487,0.4660390047074647,0.39004707464694016,0.14391392064559516,32876.0,10905.0,11110.0
2016-05-19_15,67374,118656,87,834,30,951,325,605,460,211,1276,0.47413793103448276,0.3605015673981191,0.16536050156739812,33057.0,10959.0,11193.0
2016-05-19_16,67664,119419,125,912,59,1096,374,705,555,210,1470,0.47959183673469385,0.37755102040816324,0.14285714285714285,33251.0,11049.0,11292.0
2016-05-19_17,67940,120213,113,1010,42,1165,392,710,613,234,1557,0.45600513808606297,0.3937058445728966,0.15028901734104047,33525.0,11162.0,11359.0
2016-05-19_18,68201,120988,103,1087,52,1242,313,689,681,185,1555,0.44308681672025724,0.4379421221864952,0.1189710610932476,33999.0,11221.0,11392.0
2016-05-19_19,68621,121879,123,1137,35,1295,483,722,871,185,1778,0.40607424071991,0.4898762654668167,0.10404949381327334,34377.0,11302.0,11456.0
2016-05-19_20,68962,122803,155,1180,36,1371,280,635,792,224,1651,0.38461538461538464,0.47970926711084194,0.13567534827377348,34739.0,11343.0,11501.0
2016-05-19_21,69333,123812,152,1306,62,1520,458,740,824,414,1978,0.3741152679474216,0.416582406471183,0.20930232558139536,35146.0,11450.0,11659.0
2016-05-19_22,69927,125202,200,1449,84,1733,595,843,855,630,2328,0.36211340206185566,0.36726804123711343,0.2706185567010309,35364.0,11623.0,11963.0
2016-05-19_23,70123,125731,77,596,27,700,154,283,357,214,854,0.33138173302107726,0.4180327868852459,0.2505854800936768,35522.0,11671.0,12045.0
2016-05-20_00,70193,125918,29,239,9,277,72,114,146,89,349,0.32664756446991405,0.4183381088825215,0.25501432664756446,35594.0,11686.0,12082.0
2016-05-20_01,70235,126040,10,158,7,175,36,58,117,36,211,0.27488151658767773,0.5545023696682464,0.17061611374407584,35646.0,11699.0,12094.0
2016-05-20_02,70255,126102,5,79,0,84,22,38,48,20,106,0.3584905660377358,0.4528301886792453,0.18867924528301888,35679.0,11703.0,12101.0
2016-05-20_03,70291,126189,5,114,2,121,30,57,52,42,151,0.37748344370860926,0.3443708609271523,0.2781456953642384,35710.0,11706.0,12123.0
2016-05-20_04,70339,126302,5,139,3,147,62,58,92,59,209,0.27751196172248804,0.44019138755980863,0.2822966507177033,35744.0,11708.0,12147.0
2016-05-20_05,70469,126655,30,408,9,447,153,254,227,119,600,0.42333333333333334,0.37833333333333335,0.19833333333333333,35853.0,11756.0,12209.0
2016-05-20_06,70744,127341,90,848,33,971,337,507,527,274,1308,0.3876146788990826,0.4029051987767584,0.20948012232415902,36057.0,11822.0,12344.0
2016-05-20_07,71161,128398,156,1296,63,1515,470,845,782,358,1985,0.4256926952141058,0.39395465994962214,0.18035264483627203,36379.0,11917.0,12509.0
2016-05-20_08,71644,129576,120,1334,72,1526,492,942,738,338,2018,0.466798810703667,0.3657086223984143,0.16749256689791872,36697.0,12038.0,12625.0
2016-05-20_09,72196,130749,142,1312,68,1522,504,874,676,476,2026,0.43139190523198423,0.3336623889437315,0.2349457058242843,36991.0,12155.0,12710.0
2016-05-20_10,72679,131710,158,1061,77,1296,496,903,594,295,1792,0.50390625,0.3314732142857143,0.16462053571428573,37236.0,12227.0,12773.0
2016-05-20_11,73088,132576,139,1051,59,1249,462,739,695,277,1711,0.4319111630625365,0.40619520748100524,0.16189362945645822,37544.0,12287.0,12852.0
2016-05-20_12,73486,133517,133,1055,66,1254,405,815,570,274,1659,0.4912597950572634,0.3435804701627486,0.16515973477998794,37823.0,12370.0,12944.0
2016-05-20_13,73958,134486,140,1176,62,1378,581,1090,592,277,1959,0.5564063297600816,0.30219499744767736,0.14139867279224094,38136.0,12456.0,13021.0
2016-05-20_14,74337,135448,158,1084,62,1304,366,836,566,268,1670,0.5005988023952096,0.3389221556886228,0.16047904191616766,38387.0,12529.0,13083.0
2016-05-20_15,74665,136314,112,1060,50,1222,376,750,619,229,1598,0.4693366708385482,0.38735919899874843,0.14330413016270338,38697.0,12595.0,13175.0
2016-05-20_16,75015,137263,149,1184,46,1379,388,714,794,259,1767,0.40407470288624786,0.4493491794001132,0.14657611771363893,39036.0,12667.0,13279.0
2016-05-20_17,75337,138093,136,1047,41,1224,369,598,771,224,1593,0.3753923414940364,0.4839924670433145,0.1406151914626491,39340.0,12736.0,13346.0
2016-05-20_18,75607,138868,121,944,55,1120,323,560,662,221,1443,0.3880803880803881,0.4587664587664588,0.15315315315315314,39641.0,12785.0,13408.0
2016-05-20_19,75906,139671,129,1060,49,1238,298,559,756,221,1536,0.3639322916666667,0.4921875,0.14388020833333334,39980.0,12872.0,13452.0
2016-05-20_20,76129,140407,84,891,42,1017,235,495,556,201,1252,0.3953674121405751,0.4440894568690096,0.16054313099041534,40264.0,12910.0,13502.0
2016-05-20_21,76467,141262,152,961,60,1173,500,638,666,369,1673,0.38135086670651525,0.3980872683801554,0.22056186491332935,40445.0,12998.0,13631.0
2016-05-20_22,76652,141886,99,749,44,892,244,410,538,188,1136,0.3609154929577465,0.4735915492957746,0.16549295774647887,40638.0,13050.0,13709.0
2016-05-20_23,76763,142228,45,383,32,460,134,196,249,149,594,0.32996632996632996,0.41919191919191917,0.25084175084175087,40729.0,13071.0,13736.0
2016-05-21_00,76824,142381,33,190,4,227,100,130,120,77,327,0.39755351681957185,0.3669724770642202,0.23547400611620795,40787.0,13078.0,13746.0
2016-05-21_01,76865,142491,10,132,3,145,57,59,96,47,202,0.29207920792079206,0.4752475247524752,0.23267326732673269,40818.0,13085.0,13754.0
2016-05-21_02,76901,142584,12,130,12,154,61,76,91,48,215,0.35348837209302325,0.4232558139534884,0.22325581395348837,40861.0,13086.0,13764.0
2016-05-21_03,76926,142668,5,122,3,130,43,45,76,52,173,0.26011560693641617,0.4393063583815029,0.30057803468208094,40886.0,13091.0,13772.0
2016-05-21_04,76966,142766,9,135,5,149,75,64,94,66,224,0.2857142857142857,0.41964285714285715,0.29464285714285715,40934.0,13098.0,13780.0
2016-05-21_05,77025,142956,16,262,9,287,117,128,182,94,404,0.31683168316831684,0.4504950495049505,0.23267326732673269,41003.0,13115.0,13795.0
2016-05-21_06,77175,143463,52,621,29,702,238,271,473,196,940,0.28829787234042553,0.5031914893617021,0.20851063829787234,41156.0,13152.0,13831.0
2016-05-21_07,77460,144180,75,887,51,1013,341,474,650,230,1354,0.3500738552437223,0.48005908419497784,0.16986706056129985,41390.0,13200.0,13902.0
2016-05-21_08,77850,145017,114,933,59,1106,441,635,597,315,1547,0.41047188106011634,0.3859082094376212,0.20361990950226244,41545.0,13259.0,13988.0
2016-05-21_09,78214,145987,149,1145,85,1379,450,659,840,330,1829,0.36030617823947514,0.4592673592126845,0.18042646254784034,41798.0,13354.0,14059.0
2016-05-21_10,78548,146796,136,896,61,1093,393,498,734,254,1486,0.3351278600269179,0.4939434724091521,0.17092866756393002,41953.0,13419.0,14151.0
2016-05-21_11,78828,147598,141,911,60,1112,335,558,698,191,1447,0.38562543192812715,0.4823773324118867,0.13199723565998617,42132.0,13464.0,14234.0
2016-05-21_12,79090,148316,111,886,43,1040,330,495,674,201,1370,0.3613138686131387,0.491970802919708,0.1467153284671533,42356.0,13549.0,14305.0
2016-05-21_13,79327,149128,99,1088,66,1253,336,490,900,199,1589,0.30837004405286345,0.5663939584644431,0.1252359974826935,42636.0,13599.0,14433.0
2016-05-21_14,79573,149860,107,960,26,1093,260,444,725,184,1353,0.328159645232816,0.5358462675535847,0.1359940872135994,42877.0,13623.0,14578.0
2016-05-21_15,79785,150613,113,977,67,1157,276,404,827,202,1433,0.2819260293091417,0.5771109560362875,0.14096301465457084,43170.0,13649.0,14662.0
2016-05-21_16,79975,151338,83,982,57,1122,245,452,726,189,1367,0.3306510607168983,0.5310899780541332,0.13825896122896855,43474.0,13678.0,14761.0
2016-05-21_17,80203,152069,107,930,60,1097,208,434,644,227,1305,0.3325670498084291,0.4934865900383142,0.1739463601532567,43768.0,13759.0,14831.0
2016-05-21_18,80400,152845,102,1021,38,1161,311,566,689,217,1472,0.3845108695652174,0.468070652173913,0.14741847826086957,44074.0,13815.0,14920.0
2016-05-21_19,80616,153623,103,1025,37,1165,281,425,779,242,1446,0.2939142461964039,0.5387275242047026,0.1673582295988935,44400.0,13854.0,14977.0
2016-05-21_20,80805,154466,91,1073,50,1214,217,454,765,212,1431,0.3172606568832984,0.5345911949685535,0.14814814814814814,44786.0,13900.0,15071.0
2016-05-21_21,80983,155163,71,873,48,992,209,440,592,169,1201,0.36636136552872606,0.4929225645295587,0.14071606994171523,45054.0,13944.0,15116.0
2016-05-21_22,81151,155837,73,879,45,997,212,445,555,209,1209,0.3680727874276261,0.45905707196029777,0.1728701406120761,45323.0,14023.0,15148.0
2016-05-21_23,81267,156244,61,492,25,578,118,227,358,111,696,0.3261494252873563,0.514367816091954,0.15948275862068967,45491.0,14043.0,15179.0
2016-05-22_00,81333,156435,16,277,10,303,78,137,190,54,381,0.35958005249343833,0.49868766404199477,0.14173228346456693,45595.0,14062.0,15186.0
2016-05-22_01,81369,156538,9,140,13,162,34,59,107,30,196,0.3010204081632653,0.5459183673469388,0.15306122448979592,45636.0,14066.0,15188.0
2016-05-22_02,81406,156622,12,109,2,123,42,76,56,33,165,0.46060606060606063,0.3393939393939394,0.2,45667.0,14071.0,15213.0
2016-05-22_03,81434,156697,7,103,4,114,41,51,67,37,155,0.32903225806451614,0.432258064516129,0.23870967741935484,45700.0,14074.0,15238.0
2016-05-22_04,81465,156776,10,108,1,119,51,60,75,35,170,0.35294117647058826,0.4411764705882353,0.20588235294117646,45726.0,14078.0,15248.0
2016-05-22_05,81510,156911,11,225,3,239,77,101,160,55,316,0.31962025316455694,0.5063291139240507,0.17405063291139242,45811.0,14086.0,15253.0
2016-05-22_06,81628,157321,52,546,27,625,189,250,427,137,814,0.3071253071253071,0.5245700245700246,0.1683046683046683,46019.0,14113.0,15277.0
2016-05-22_07,81847,158010,74,881,49,1004,282,447,601,238,1286,0.3475894245723173,0.46734059097978226,0.18506998444790046,46281.0,14247.0,15323.0
2016-05-22_08,82342,159317,174,1536,70,1780,598,856,1016,506,2378,0.3599663582842725,0.4272497897392767,0.2127838519764508,46644.0,14562.0,15557.0
2016-05-22_09,82832,160694,197,1546,55,1798,507,873,967,465,2305,0.3787418655097614,0.4195227765726681,0.2017353579175705,46894.0,14773.0,15820.0
2016-05-22_10,83266,161877,184,1312,81,1577,547,796,790,538,2124,0.3747645951035782,0.371939736346516,0.2532956685499058,47156.0,14951.0,16002.0
2016-05-22_11,83677,162971,177,1258,72,1507,530,726,768,543,2037,0.35640648011782033,0.37702503681885124,0.2665684830633284,47403.0,15158.0,16129.0
2016-05-22_12,83988,163849,132,1068,67,1267,365,574,651,407,1632,0.35171568627450983,0.39889705882352944,0.2493872549019608,47631.0,15310.0,16195.0
2016-05-22_13,84222,164595,119,919,56,1094,348,472,678,292,1442,0.3273231622746186,0.47018030513176146,0.20249653259361997,47901.0,15424.0,16242.0
2016-05-22_14,84440,165303,103,882,38,1023,273,463,606,227,1296,0.35725308641975306,0.4675925925925926,0.17515432098765432,48136.0,15496.0,16291.0
2016-05-22_15,84666,166124,99,1056,54,1209,265,532,649,293,1474,0.36092265943012214,0.44029850746268656,0.19877883310719133,48389.0,15577.0,16350.0
2016-05-22_16,84944,166889,110,887,39,1036,249,523,518,244,1285,0.40700389105058365,0.4031128404669261,0.18988326848249026,48573.0,15625.0,16468.0
2016-05-22_17,85232,167761,116,1074,43,1233,304,546,740,251,1537,0.35523747560182173,0.4814573845152895,0.16330513988288875,48873.0,15688.0,16576.0
2016-05-22_18,85494,168611,138,1148,45,1331,265,513,810,273,1596,0.32142857142857145,0.5075187969924813,0.17105263157894737,49255.0,15782.0,16663.0
2016-05-22_19,85794,169571,130,1271,49,1450,280,663,772,295,1730,0.3832369942196532,0.446242774566474,0.17052023121387283,49631.0,15923.0,16733.0
2016-05-22_20,86154,170587,135,1228,61,1424,271,625,811,259,1695,0.3687315634218289,0.4784660766961652,0.1528023598820059,50002.0,16117.0,16829.0
2016-05-22_21,86552,171832,144,1686,69,1899,340,677,1145,417,2239,0.3023671281822242,0.5113890129522108,0.186243858865565,50619.0,16257.0,17074.0
2016-05-22_22,86773,172606,104,940,57,1101,281,431,698,253,1382,0.3118668596237337,0.5050651230101303,0.18306801736613604,50894.0,16320.0,17167.0
2016-05-22_23,86880,172922,36,391,12,439,160,168,303,128,599,0.28046744574290483,0.5058430717863105,0.21368948247078465,50999.0,16341.0,17214.0
2016-05-23_00,86936,173072,18,225,11,254,109,113,162,88,363,0.31129476584022037,0.4462809917355372,0.24242424242424243,51078.0,16348.0,17242.0
2016-05-23_01,86986,173176,16,140,3,159,87,61,82,103,246,0.24796747967479674,0.3333333333333333,0.4186991869918699,51117.0,16356.0,17270.0
2016-05-23_02,87018,173262,12,115,2,129,72,45,94,62,201,0.22388059701492538,0.46766169154228854,0.30845771144278605,51156.0,16362.0,17282.0
2016-05-23_03,87045,173345,4,125,1,130,52,59,71,52,182,0.3241758241758242,0.3901098901098901,0.2857142857142857,51189.0,16369.0,17293.0
2016-05-23_04,87089,173447,7,153,0,160,119,100,96,83,279,0.35842293906810035,0.34408602150537637,0.2974910394265233,51233.0,16378.0,17304.0
2016-05-23_05,87172,173697,39,381,13,433,256,199,329,161,689,0.2888243831640058,0.47750362844702465,0.23367198838896952,51362.0,16402.0,17340.0
2016-05-23_06,87478,174535,87,1045,36,1168,573,604,729,408,1741,0.3469270534175761,0.4187248707639288,0.23434807581849512,51669.0,16507.0,17436.0
2016-05-23_07,87985,175891,172,1695,72,1939,702,1017,984,640,2641,0.3850814085573646,0.3725861416130254,0.24233244982961,52116.0,16707.0,17562.0
2016-05-23_08,88461,177101,178,1368,68,1614,669,987,793,503,2283,0.4323258869908016,0.34734997809899254,0.22032413491020586,52421.0,16842.0,17682.0
2016-05-23_09,89102,178607,191,1723,105,2019,761,1211,973,596,2780,0.4356115107913669,0.35,0.2143884892086331,52732.0,17032.0,17940.0
2016-05-23_10,89776,180175,265,1803,118,2186,794,1339,1076,565,2980,0.4493288590604027,0.3610738255033557,0.18959731543624161,53175.0,17183.0,18132.0
2016-05-23_11,90554,181822,247,1930,102,2279,839,1493,992,633,3118,0.47883258499037845,0.3181526619627967,0.2030147530468249,53480.0,17371.0,18458.0
2016-05-23_12,91120,183309,197,1812,84,2093,708,1260,913,628,2801,0.44983934309175294,0.32595501606569083,0.22420564084255623,53745.0,17513.0,18705.0
2016-05-23_13,91563,184412,167,1368,57,1592,497,967,637,485,2089,0.46290090952608903,0.3049305887984682,0.23216850167544278,53968.0,17676.0,18858.0
2016-05-23_14,91978,185462,155,1246,58,1459,543,990,598,414,2002,0.4945054945054945,0.2987012987012987,0.20679320679320679,54133.0,17819.0,18985.0
2016-05-23_15,92468,186588,193,1319,65,1577,559,1062,669,405,2136,0.49719101123595505,0.31320224719101125,0.1896067415730337,54428.0,17942.0,19128.0
2016-05-23_16,92920,187841,173,1488,67,1728,549,1022,814,441,2277,0.4488361879666227,0.357487922705314,0.19367588932806323,54755.0,18033.0,19266.0
2016-05-23_17,93537,189110,171,1637,62,1870,789,1107,1043,509,2659,0.41632192553591574,0.3922527265889432,0.19142534787514104,55145.0,18138.0,19408.0
2016-05-23_18,94096,190437,200,1626,89,1915,708,1138,1033,452,2623,0.4338543652306519,0.3938238658025162,0.17232176896683188,55496.0,18274.0,19532.0
2016-05-23_19,94705,191983,219,1898,75,2192,750,1289,1134,519,2942,0.438137321549966,0.38545207341944254,0.17641060503059144,55920.0,18425.0,19648.0
2016-05-23_20,95258,193573,173,1939,90,2202,482,1136,1005,543,2684,0.4232488822652757,0.37444113263785395,0.20230998509687034,56380.0,18590.0,19832.0
2016-05-23_21,95850,195152,212,1944,72,2228,649,1204,1146,527,2877,0.41849148418491483,0.3983315954118874,0.18317692040319777,56818.0,18744.0,20033.0
2016-05-23_22,96200,196365,170,1521,42,1733,450,784,965,434,2183,0.35913879981676594,0.44205222171323866,0.19880897846999543,57145.0,18842.0,20198.0
2016-05-23_23,96328,196881,80,621,18,719,201,311,398,211,920,0.33804347826086956,0.4326086956521739,0.22934782608695653,57292.0,18907.0,20252.0
2016-05-24_00,96391,197071,21,273,7,301,111,146,180,86,412,0.35436893203883496,0.4368932038834951,0.2087378640776699,57361.0,18932.0,20270.0
2016-05-24_01,96423,197150,7,98,4,109,81,76,73,41,190,0.4,0.38421052631578945,0.21578947368421053,57392.0,18936.0,20277.0
2016-05-24_02,96445,197201,9,87,6,102,47,60,46,43,149,0.40268456375838924,0.3087248322147651,0.28859060402684567,57412.0,18947.0,20286.0
2016-05-24_03,96475,197277,8,100,0,108,37,59,48,38,145,0.4068965517241379,0.3310344827586207,0.2620689655172414,57428.0,18956.0,20305.0
2016-05-24_04,96531,197421,22,174,4,200,88,110,119,59,288,0.3819444444444444,0.4131944444444444,0.2048611111111111,57464.0,18978.0,20337.0
2016-05-24_05,96680,197860,49,554,23,626,220,301,363,182,846,0.3557919621749409,0.42907801418439717,0.21513002364066194,57563.0,19025.0,20399.0
2016-05-24_06,97033,198727,110,1047,50,1207,411,620,631,367,1618,0.3831891223733004,0.3899876390605686,0.226823238566131,57762.0,19126.0,20537.0
2016-05-24_07,97530,199998,188,1611,71,1870,625,1044,938,513,2495,0.418436873747495,0.37595190380761523,0.20561122244488977,58117.0,19289.0,20679.0
2016-05-24_08,98128,201330,188,1504,79,1771,690,1165,784,512,2461,0.47338480292564,0.3185696871190573,0.20804550995530272,58299.0,19419.0,20803.0
2016-05-24_09,98644,202521,200,1437,83,1720,699,1089,798,532,2419,0.45018602728400164,0.329888383629599,0.21992558908639934,58496.0,19522.0,20987.0
2016-05-24_10,99171,203692,160,1442,80,1682,737,1097,822,500,2419,0.45349317899958663,0.33980983877635385,0.20669698222405952,58767.0,19635.0,21172.0
2016-05-24_11,99782,204935,202,1464,92,1758,638,1216,717,463,2396,0.5075125208681135,0.2992487479131887,0.19323873121869783,59028.0,19697.0,21353.0
2016-05-24_12,100229,206164,161,1526,69,1756,612,1095,810,463,2368,0.4624155405405405,0.3420608108108108,0.19552364864864866,59259.0,19788.0,21451.0
2016-05-24_13,100712,207263,146,1313,80,1539,572,1171,580,360,2111,0.5547134059687352,0.2747513027001421,0.1705352913311227,59413.0,19917.0,21638.0
2016-05-24_14,101163,208395,148,1420,72,1640,536,1146,663,367,2176,0.5266544117647058,0.3046875,0.16865808823529413,59697.0,20031.0,21762.0
2016-05-24_15,101557,209551,130,1534,82,1746,538,1114,751,419,2284,0.48774080560420313,0.3288091068301226,0.18345008756567427,60035.0,20133.0,21871.0
2016-05-24_16,102022,210731,188,1486,74,1748,650,1005,927,466,2398,0.41909924937447873,0.3865721434528774,0.19432860717264386,60308.0,20306.0,22059.0
2016-05-24_17,102468,211913,180,1440,75,1695,548,975,851,417,2243,0.43468568880962993,0.3794025858225591,0.18591172536781098,60576.0,20456.0,22214.0
2016-05-24_18,102835,213093,139,1601,52,1792,442,905,966,363,2234,0.40510295434198745,0.432408236347359,0.16248880931065354,60927.0,20562.0,22420.0
2016-05-24_19,103241,214373,177,1748,58,1983,521,997,1103,404,2504,0.3981629392971246,0.44049520766773165,0.16134185303514376,61390.0,20700.0,22603.0
2016-05-24_20,103699,215638,145,1644,74,1863,461,906,1026,392,2324,0.3898450946643718,0.4414802065404475,0.1686746987951807,61799.0,20771.0,22907.0
2016-05-24_21,104225,217129,180,1798,102,2080,516,1076,1147,373,2596,0.41448382126348227,0.4418335901386749,0.14368258859784283,62206.0,20823.0,23164.0
2016-05-24_22,104512,217943,112,1026,63,1201,267,577,677,214,1468,0.3930517711171662,0.4611716621253406,0.14577656675749318,62465.0,20871.0,23318.0
2016-05-24_23,104628,218349,58,583,20,661,193,296,376,182,854,0.34660421545667447,0.44028103044496486,0.21311475409836064,62639.0,20902.0,23375.0
2016-05-25_00,104676,218543,40,242,17,299,91,111,187,92,390,0.2846153846153846,0.4794871794871795,0.2358974358974359,62706.0,20909.0,23412.0
2016-05-25_01,104701,218639,13,115,5,133,54,69,70,48,187,0.3689839572192513,0.37433155080213903,0.25668449197860965,62732.0,20915.0,23432.0
2016-05-25_02,104726,218717,9,89,1,99,53,39,55,58,152,0.2565789473684211,0.3618421052631579,0.3815789473684211,62747.0,20919.0,23458.0
2016-05-25_03,104757,218805,7,130,4,141,81,67,85,70,222,0.30180180180180183,0.38288288288288286,0.3153153153153153,62769.0,20930.0,23491.0
2016-05-25_04,104794,218931,7,186,6,199,76,70,123,82,275,0.2545454545454545,0.44727272727272727,0.29818181818181816,62805.0,20934.0,23526.0
2016-05-25_05,104907,219246,36,409,10,455,253,219,317,172,708,0.3093220338983051,0.4477401129943503,0.24293785310734464,62901.0,20953.0,23576.0
2016-05-25_06,105197,220049,115,1006,62,1183,501,564,750,370,1684,0.334916864608076,0.44536817102137766,0.21971496437054633,63109.0,21100.0,23664.0
2016-05-25_07,105703,221430,213,1647,82,1942,729,1052,938,681,2671,0.3938599775365032,0.35117933358292774,0.25496068888056905,63374.0,21340.0,23817.0
2016-05-25_08,106187,222719,176,1628,89,1893,674,1156,919,492,2567,0.4503311258278146,0.358005453837164,0.19166342033502143,63641.0,21528.0,23984.0
2016-05-25_09,106623,223941,144,1497,79,1720,682,1086,893,423,2402,0.4521232306411324,0.3717735220649459,0.17610324729392174,63853.0,21625.0,24069.0
2016-05-25_10,107053,225087,193,1363,82,1638,654,1044,805,443,2292,0.45549738219895286,0.3512216404886562,0.1932809773123909,64112.0,21740.0,24151.0
2016-05-25_11,107463,226149,175,1352,71,1598,702,1014,905,381,2300,0.4408695652173913,0.3934782608695652,0.1656521739130435,64429.0,21854.0,24243.0
2016-05-25_12,107869,227070,183,1146,59,1388,630,916,782,320,2018,0.45391476709613476,0.3875123885034688,0.15857284440039643,64686.0,21941.0,24332.0
2016-05-25_13,108253,228051,174,1202,73,1449,556,888,795,322,2005,0.4428927680798005,0.39650872817955113,0.16059850374064838,64982.0,22014.0,24460.0
2016-05-25_14,108616,228987,167,1218,50,1435,493,885,787,256,1928,0.45902489626556015,0.40819502074688796,0.13278008298755187,65300.0,22113.0,24618.0
2016-05-25_15,108990,229992,154,1246,61,1461,553,887,794,333,2014,0.4404170804369414,0.394240317775571,0.16534260178748758,65569.0,22203.0,24799.0
2016-05-25_16,109315,231022,145,1307,63,1515,548,893,849,321,2063,0.4328647600581677,0.41153659718856034,0.15559864275327193,65868.0,22309.0,24963.0
2016-05-25_17,109731,232147,161,1447,68,1676,561,926,995,316,2237,0.4139472507822977,0.44479213232007153,0.14126061689763075,66175.0,22406.0,25116.0
2016-05-25_18,110090,233339,175,1543,59,1777,547,888,1107,329,2324,0.38209982788296043,0.4763339070567986,0.14156626506024098,66550.0,22477.0,25242.0
2016-05-25_19,110484,234557,160,1635,57,1852,415,978,951,338,2267,0.43140714600794,0.419497132774592,0.14909572121746803,67003.0,22568.0,25380.0
2016-05-25_20,110953,235880,159,1734,97,1990,466,961,1117,378,2456,0.3912866449511401,0.4548045602605863,0.15390879478827363,67458.0,22670.0,25541.0
2016-05-25_21,111351,237234,158,1735,77,1970,466,973,1081,382,2436,0.3994252873563218,0.44376026272577995,0.1568144499178982,67911.0,22730.0,25689.0
2016-05-25_22,111582,238032,130,1021,49,1200,262,635,610,217,1462,0.43433652530779754,0.4172366621067031,0.1484268125854993,68121.0,22787.0,25769.0
2016-05-25_23,111694,238455,71,591,23,685,167,315,397,140,852,0.36971830985915494,0.465962441314554,0.1643192488262911,68285.0,22811.0,25803.0
2016-05-26_00,111753,238648,33,230,18,281,88,166,138,65,369,0.44986449864498645,0.37398373983739835,0.17615176151761516,68353.0,22827.0,25823.0
2016-05-26_01,111787,238791,15,187,8,210,35,99,104,42,245,0.40408163265306124,0.42448979591836733,0.17142857142857143,68402.0,22830.0,25847.0
2016-05-26_02,111815,238869,9,100,1,110,34,65,51,28,144,0.4513888888888889,0.3541666666666667,0.19444444444444445,68424.0,22834.0,25855.0
2016-05-26_03,111839,238951,6,115,2,123,30,45,87,21,153,0.29411764705882354,0.5686274509803921,0.13725490196078433,68458.0,22838.0,25864.0
2016-05-26_04,111877,239085,11,186,3,200,61,93,117,51,261,0.3563218390804598,0.4482758620689655,0.19540229885057472,68506.0,22845.0,25890.0
2016-05-26_05,111982,239395,32,399,16,447,169,244,281,91,616,0.3961038961038961,0.45616883116883117,0.14772727272727273,68618.0,22856.0,25954.0
2016-05-26_06,112237,240140,99,967,50,1116,393,650,623,236,1509,0.43074884029158383,0.41285619615639496,0.1563949635520212,68894.0,22909.0,26028.0
2016-05-26_07,112594,241309,148,1477,83,1708,520,904,916,408,2228,0.40574506283662476,0.4111310592459605,0.18312387791741472,69355.0,23045.0,26130.0
2016-05-26_08,113051,242434,189,1375,68,1632,689,1014,909,398,2321,0.43688065489013356,0.3916415338216286,0.17147781128823783,69642.0,23182.0,26220.0
2016-05-26_09,113433,243529,170,1372,74,1616,605,944,876,401,2221,0.425033768572715,0.3944169293111211,0.18054930211616388,69974.0,23255.0,26284.0
2016-05-26_10,113841,244546,166,1264,65,1495,582,942,729,406,2077,0.4535387578237843,0.35098700048146364,0.19547424169475205,70297.0,23323.0,26375.0
2016-05-26_11,114282,245497,160,1170,83,1413,663,1025,713,338,2076,0.49373795761079,0.34344894026974954,0.1628131021194605,70581.0,23369.0,26434.0
2016-05-26_12,114658,246424,144,1190,85,1419,596,944,751,320,2015,0.4684863523573201,0.3727047146401985,0.1588089330024814,70950.0,23429.0,26508.0
2016-05-26_13,115041,247432,155,1269,65,1489,554,990,783,270,2043,0.4845814977973568,0.3832599118942731,0.13215859030837004,71328.0,23473.0,26638.0
2016-05-26_14,115364,248256,108,1051,56,1215,453,837,631,200,1668,0.5017985611510791,0.37829736211031173,0.11990407673860912,71619.0,23490.0,26716.0
2016-05-26_15,115699,249113,137,1168,53,1358,445,882,641,280,1803,0.4891846921797005,0.3555185801442041,0.1552967276760954,72003.0,23521.0,26768.0
2016-05-26_16,115972,249922,111,1048,60,1219,424,800,630,213,1643,0.48691418137553255,0.38344491783323187,0.12964090079123555,72317.0,23547.0,26821.0
2016-05-26_17,116304,250807,143,1205,50,1398,543,921,758,262,1941,0.47449768160741884,0.3905203503348789,0.1349819680577022,72699.0,23563.0,26849.0
2016-05-26_18,116641,251738,153,1348,53,1554,533,958,859,270,2087,0.4590321034978438,0.411595591758505,0.12937230474365116,73133.0,23602.0,26989.0
2016-05-26_19,117666,253604,329,2285,101,2715,1598,2323,1312,678,4313,0.5386042198006028,0.3041966148852307,0.15719916531416647,73675.0,23723.0,27540.0
2016-05-26_20,118327,255249,278,1979,102,2359,642,1430,1073,498,3001,0.47650783072309233,0.3575474841719427,0.16594468510496502,74151.0,23815.0,27781.0
2016-05-26_21,118840,256691,242,1747,77,2066,648,1161,1060,493,2714,0.42778187177597643,0.39056742815033163,0.18165070007369197,74610.0,23882.0,27953.0
2016-05-26_22,119497,258224,301,1672,111,2084,1095,1400,1072,707,3179,0.4403900597672224,0.3372129600503303,0.2223969801824473,74846.0,24164.0,28242.0
2016-05-26_23,119724,258933,144,875,30,1049,339,662,522,204,1388,0.4769452449567723,0.3760806916426513,0.14697406340057637,75053.0,24280.0,28329.0
2016-05-27_00,119814,259198,48,351,8,407,114,219,209,93,521,0.42034548944337813,0.40115163147792704,0.1785028790786948,75138.0,24310.0,28373.0
2016-05-27_01,119905,259392,34,218,3,255,103,100,89,169,358,0.27932960893854747,0.24860335195530725,0.4720670391061452,75181.0,24320.0,28402.0
2016-05-27_02,119968,259520,12,160,2,174,52,102,64,60,226,0.45132743362831856,0.2831858407079646,0.26548672566371684,75199.0,24323.0,28456.0
2016-05-27_03,120018,259629,10,141,2,153,106,70,51,138,259,0.2702702702702703,0.1969111969111969,0.5328185328185329,75212.0,24355.0,28482.0
2016-05-27_04,120081,259806,19,225,4,248,157,121,134,150,405,0.29876543209876544,0.3308641975308642,0.37037037037037035,75256.0,24381.0,28520.0
2016-05-27_05,120226,260221,57,586,20,663,230,332,331,230,893,0.3717805151175812,0.3706606942889138,0.25755879059350506,75369.0,24455.0,28584.0
2016-05-27_06,120519,261074,107,1229,41,1377,471,678,699,471,1848,0.36688311688311687,0.3782467532467532,0.25487012987012986,75737.0,24596.0,28760.0
2016-05-27_07,120972,262142,207,1413,69,1689,663,1014,832,506,2352,0.43112244897959184,0.35374149659863946,0.2151360544217687,76093.0,24780.0,28939.0
2016-05-27_08,121378,263264,223,1401,74,1698,700,972,919,507,2398,0.4053377814845705,0.3832360300250208,0.21142618849040867,76503.0,24943.0,29048.0
2016-05-27_09,121804,264268,172,1326,63,1561,569,883,761,486,2130,0.41455399061032866,0.3572769953051643,0.22816901408450704,76796.0,25075.0,29192.0
2016-05-27_10,122197,265171,188,1107,56,1351,576,846,650,431,1927,0.43902439024390244,0.33731188375713544,0.22366372599896212,77016.0,25182.0,29292.0
2016-05-27_11,122544,266164,160,1263,75,1498,611,934,803,372,2109,0.44286391654812707,0.3807491702228544,0.1763869132290185,77319.0,25299.0,29354.0
2016-05-27_12,122864,267031,156,1110,67,1333,534,841,667,359,1867,0.45045527584359935,0.35725763256561327,0.19228709159078736,77585.0,25394.0,29418.0
2016-05-27_13,123157,267817,125,1046,50,1221,422,694,648,301,1643,0.4223980523432745,0.3944004869141814,0.18320146074254412,77929.0,25466.0,29476.0
2016-05-27_14,123397,268560,156,940,41,1137,430,647,612,308,1567,0.41289087428206767,0.39055520102105934,0.196553924696873,78152.0,25542.0,29533.0
2016-05-27_15,123627,269255,120,968,47,1135,407,689,579,274,1542,0.446822308690013,0.3754863813229572,0.17769130998702984,78410.0,25627.0,29579.0
2016-05-27_16,123883,269940,101,940,36,1077,384,654,513,294,1461,0.44763860369609854,0.351129363449692,0.20123203285420946,78627.0,25711.0,29639.0
2016-05-27_17,124140,270768,147,1135,53,1335,381,771,667,278,1716,0.4493006993006993,0.3886946386946387,0.16200466200466201,78973.0,25786.0,29701.0
2016-05-27_18,124382,271478,121,967,41,1129,330,643,606,210,1459,0.4407128169979438,0.4153529814941741,0.1439342015078821,79301.0,25845.0,29759.0
2016-05-27_19,124584,272185,108,973,55,1136,344,630,610,240,1480,0.42567567567567566,0.41216216216216217,0.16216216216216217,79630.0,25896.0,29799.0
2016-05-27_20,124817,272939,99,1075,61,1235,266,552,784,165,1501,0.3677548301132578,0.5223184543637575,0.10992671552298468,80027.0,25924.0,29847.0
2016-05-27_21,125047,273790,105,1280,43,1428,314,601,914,227,1742,0.3450057405281286,0.5246842709529277,0.13030998851894374,80550.0,25969.0,29909.0
2016-05-27_22,125195,274356,99,806,48,953,212,373,619,173,1165,0.3201716738197425,0.5313304721030043,0.14849785407725322,80867.0,26004.0,29941.0
2016-05-27_23,125284,274686,68,449,10,527,106,173,374,86,633,0.27330173775671407,0.5908372827804107,0.1358609794628752,81043.0,26024.0,29952.0
2016-05-28_00,125333,274875,36,224,10,270,52,107,170,45,322,0.33229813664596275,0.5279503105590062,0.13975155279503104,81114.0,26032.0,29961.0
2016-05-28_01,125360,274984,24,117,2,143,30,53,107,13,173,0.3063583815028902,0.6184971098265896,0.07514450867052024,81150.0,26032.0,29970.0
2016-05-28_02,125380,275051,13,104,2,119,29,53,79,16,148,0.3581081081081081,0.5337837837837838,0.10810810810810811,81189.0,26037.0,29982.0
2016-05-28_03,125401,275119,4,93,1,98,38,34,82,20,136,0.25,0.6029411764705882,0.14705882352941177,81229.0,26040.0,29984.0
2016-05-28_04,125429,275202,6,120,2,128,23,36,89,26,151,0.23841059602649006,0.5894039735099338,0.17218543046357615,81272.0,26042.0,29990.0
2016-05-28_05,125480,275408,19,320,12,351,87,136,256,46,438,0.3105022831050228,0.5844748858447488,0.1050228310502283,81386.0,26056.0,30004.0
2016-05-28_06,125614,275786,36,591,18,645,167,272,453,87,812,0.33497536945812806,0.5578817733990148,0.10714285714285714,81609.0,26070.0,30072.0
2016-05-28_07,125804,276430,80,862,39,981,279,442,619,199,1260,0.35079365079365077,0.49126984126984125,0.15793650793650793,81893.0,26092.0,30117.0
2016-05-28_08,126020,277141,95,944,51,1090,353,563,619,261,1443,0.39015939015939016,0.42896742896742895,0.18087318087318088,82145.0,26155.0,30143.0
2016-05-28_09,126346,278052,142,1100,49,1291,384,587,690,398,1675,0.35044776119402987,0.41194029850746267,0.23761194029850746,82412.0,26234.0,30185.0
2016-05-28_10,126623,278873,136,974,32,1142,387,653,563,313,1529,0.4270765206017005,0.368214519293656,0.20470896010464357,82603.0,26301.0,30229.0
2016-05-28_11,126918,279682,134,998,70,1202,347,645,636,268,1549,0.41639767591994836,0.41058747579083277,0.17301484828921884,82832.0,26381.0,30320.0
2016-05-28_12,127294,280528,111,1084,62,1257,338,561,583,451,1595,0.35172413793103446,0.36551724137931035,0.2827586206896552,83124.0,26460.0,30348.0
2016-05-28_13,127575,281315,128,1048,34,1210,352,550,676,336,1562,0.352112676056338,0.4327784891165173,0.21510883482714468,83385.0,26569.0,30380.0
2016-05-28_14,127765,281938,102,857,43,1002,267,428,590,251,1269,0.33727344365642237,0.4649330181245075,0.19779353821907014,83647.0,26634.0,30406.0
2016-05-28_15,127951,282625,115,858,37,1010,285,403,648,244,1295,0.3111969111969112,0.5003861003861004,0.18841698841698842,83835.0,26714.0,30432.0
2016-05-28_16,128142,283317,114,891,36,1041,219,400,616,244,1260,0.31746031746031744,0.4888888888888889,0.19365079365079366,84031.0,26785.0,30456.0
2016-05-28_17,128344,284065,122,984,55,1161,226,401,747,239,1387,0.2891131939437635,0.5385724585436193,0.17231434751261715,84266.0,26832.0,30503.0
2016-05-28_18,128537,284782,81,847,49,977,278,419,559,277,1255,0.33386454183266934,0.4454183266932271,0.22071713147410357,84457.0,26933.0,30513.0
2016-05-28_19,128735,285505,106,923,45,1074,317,445,721,225,1391,0.3199137311286844,0.5183321351545651,0.16175413371675054,84666.0,27030.0,30527.0
2016-05-28_20,129024,286527,121,1316,50,1487,307,481,821,492,1794,0.26811594202898553,0.4576365663322185,0.27424749163879597,84935.0,27144.0,30724.0
2016-05-28_21,129251,287375,132,1110,45,1287,233,422,824,274,1520,0.2776315789473684,0.5421052631578948,0.18026315789473685,85286.0,27210.0,30819.0
2016-05-28_22,129399,287951,85,793,37,915,208,303,616,204,1123,0.26981300089047194,0.5485307212822796,0.18165627782724844,85535.0,27260.0,30865.0
2016-05-28_23,129487,288288,68,393,46,507,128,159,348,128,635,0.2503937007874016,0.5480314960629922,0.2015748031496063,85640.0,27298.0,30886.0
2016-05-29_00,129521,288452,21,220,8,249,67,73,185,58,316,0.2310126582278481,0.5854430379746836,0.18354430379746836,85694.0,27310.0,30894.0
2016-05-29_01,129552,288551,14,115,5,134,46,56,88,36,180,0.3111111111111111,0.4888888888888889,0.2,85723.0,27327.0,30898.0
2016-05-29_02,129575,288616,8,82,8,98,26,37,64,23,124,0.29838709677419356,0.5161290322580645,0.18548387096774194,85744.0,27338.0,30906.0
2016-05-29_03,129591,288683,9,84,9,102,40,39,75,28,142,0.2746478873239437,0.528169014084507,0.19718309859154928,85773.0,27340.0,30915.0
2016-05-29_04,129621,288774,8,126,5,139,55,55,86,53,194,0.28350515463917525,0.44329896907216493,0.27319587628865977,85825.0,27355.0,30921.0
2016-05-29_05,129670,288957,25,274,9,308,82,107,189,94,390,0.2743589743589744,0.4846153846153846,0.24102564102564103,85903.0,27385.0,30931.0
2016-05-29_06,129757,289280,39,506,24,569,163,198,371,163,732,0.27049180327868855,0.5068306010928961,0.2226775956284153,86070.0,27436.0,30953.0
2016-05-29_07,129965,290013,99,957,48,1104,352,428,675,353,1456,0.29395604395604397,0.4635989010989011,0.24244505494505494,86257.0,27528.0,31060.0
2016-05-29_08,130368,291274,206,1526,58,1790,724,678,1203,633,2514,0.26968973747016706,0.4785202863961814,0.25178997613365156,86539.0,27692.0,31262.0
2016-05-29_09,130838,292698,207,1723,84,2014,517,807,1161,563,2531,0.318846305807981,0.45871197155274596,0.222441722639273,86802.0,27794.0,31490.0
2016-05-29_10,131162,293724,177,1293,42,1512,421,645,885,403,1933,0.33367822038282463,0.4578375581996896,0.20848422141748577,87108.0,27878.0,31583.0
2016-05-29_11,131393,294600,164,1080,70,1314,380,508,799,387,1694,0.29988193624557263,0.4716646989374262,0.22845336481700118,87342.0,27980.0,31669.0
2016-05-29_12,131635,295388,117,1055,56,1228,320,557,663,328,1548,0.35981912144702843,0.42829457364341084,0.21188630490956073,87576.0,28047.0,31779.0
2016-05-29_13,131813,296077,113,851,39,1003,340,454,626,263,1343,0.3380491437081162,0.466120625465376,0.19583023082650783,87750.0,28113.0,31830.0
2016-05-29_14,132020,296802,83,1052,46,1181,267,394,741,313,1448,0.27209944751381215,0.5117403314917127,0.21616022099447513,88101.0,28182.0,31913.0
2016-05-29_15,132217,297451,102,844,43,989,271,436,570,254,1260,0.346031746031746,0.4523809523809524,0.2015873015873016,88348.0,28221.0,31961.0
2016-05-29_16,132427,298243,129,1113,52,1294,275,490,751,328,1569,0.3123008285532186,0.4786488209050351,0.20905035054174634,88708.0,28284.0,32017.0
2016-05-29_17,132603,298927,127,955,46,1128,294,466,705,251,1422,0.32770745428973275,0.4957805907172996,0.17651195499296765,88973.0,28355.0,32078.0
2016-05-29_18,132818,299789,143,1210,39,1392,285,501,920,256,1677,0.29874776386404295,0.5485986881335718,0.1526535480023852,89357.0,28414.0,32105.0
2016-05-29_19,133030,300608,168,1068,53,1289,290,501,784,294,1579,0.31728942368587715,0.49651678277390754,0.1861937935402153,89677.0,28483.0,32136.0
2016-05-29_20,133234,301375,152,980,37,1169,238,474,699,234,1407,0.3368869936034115,0.4968017057569296,0.16631130063965885,89976.0,28517.0,32169.0
2016-05-29_21,133446,302202,169,997,49,1215,235,468,763,219,1450,0.32275862068965516,0.5262068965517241,0.1510344827586207,90225.0,28563.0,32200.0
2016-05-29_22,133607,302889,102,859,39,1000,145,389,596,160,1145,0.33973799126637555,0.5205240174672489,0.13973799126637554,90461.0,28607.0,32260.0
2016-05-29_23,133676,303227,65,509,24,598,140,207,396,135,738,0.2804878048780488,0.5365853658536586,0.18292682926829268,90644.0,28629.0,32293.0
2016-05-30_00,133725,303388,22,219,5,246,73,81,164,74,319,0.25391849529780564,0.5141065830721003,0.23197492163009403,90700.0,28637.0,32310.0
2016-05-30_01,133757,303511,27,171,2,200,67,102,115,50,267,0.38202247191011235,0.4307116104868914,0.18726591760299627,90740.0,28645.0,32325.0
2016-05-30_02,133775,303587,9,118,2,129,39,72,78,18,168,0.42857142857142855,0.4642857142857143,0.10714285714285714,90772.0,28651.0,32337.0
2016-05-30_03,133793,303649,2,102,5,109,21,35,84,11,130,0.2692307692307692,0.6461538461538462,0.08461538461538462,90807.0,28656.0,32343.0
2016-05-30_04,133818,303748,6,151,6,163,49,77,98,37,212,0.3632075471698113,0.46226415094339623,0.17452830188679244,90851.0,28663.0,32350.0
2016-05-30_05,133868,303916,23,230,7,260,70,128,151,51,330,0.3878787878787879,0.4575757575757576,0.15454545454545454,90915.0,28672.0,32377.0
2016-05-30_06,133966,304311,59,554,20,633,178,243,422,146,811,0.2996300863131936,0.5203452527743526,0.18002466091245375,91032.0,28712.0,32447.0
2016-05-30_07,134158,305091,128,1115,41,1284,318,486,659,457,1602,0.30337078651685395,0.41136079900124844,0.2852684144818976,91346.0,28878.0,32530.0
2016-05-30_08,134456,306143,146,1452,97,1695,411,728,946,432,2106,0.345679012345679,0.4491927825261159,0.20512820512820512,91827.0,29047.0,32637.0
2016-05-30_09,134720,307054,174,1348,71,1593,464,742,973,342,2057,0.360719494409334,0.4730189596499757,0.16626154594069031,92401.0,29139.0,32728.0
2016-05-30_10,134953,307954,263,1330,71,1664,435,703,1073,323,2099,0.33492139113863745,0.511195807527394,0.15388280133396856,92980.0,29243.0,32847.0
2016-05-30_11,135216,308780,170,1212,56,1438,425,679,869,315,1863,0.3644659151905529,0.4664519592055824,0.16908212560386474,93469.0,29313.0,32930.0
2016-05-30_12,135465,309555,143,1076,56,1275,324,515,669,415,1599,0.3220762976860538,0.41838649155722324,0.2595372107567229,93836.0,29373.0,32964.0
2016-05-30_13,135744,310432,145,1248,61,1454,301,515,813,427,1755,0.2934472934472934,0.46324786324786327,0.2433048433048433,94276.0,29426.0,33002.0
2016-05-30_14,136023,311278,168,1158,60,1386,314,581,837,282,1700,0.3417647058823529,0.4923529411764706,0.16588235294117648,94646.0,29472.0,33101.0
2016-05-30_15,136286,312062,153,1074,63,1290,354,553,802,289,1644,0.33637469586374696,0.4878345498783455,0.17579075425790755,95004.0,29523.0,33161.0
2016-05-30_16,136581,312919,122,1138,72,1332,325,565,764,328,1657,0.34097767048883526,0.46107423053711527,0.1979480989740495,95356.0,29570.0,33237.0
2016-05-30_17,136843,313719,159,1079,73,1311,360,596,748,327,1671,0.3566726511071215,0.44763614602034707,0.19569120287253142,95710.0,29613.0,33273.0
2016-05-30_18,137080,314537,154,1191,61,1406,337,585,847,311,1743,0.33562822719449226,0.4859437751004016,0.17842799770510614,96144.0,29652.0,33317.0
2016-05-30_19,137345,315497,204,1335,64,1603,317,615,984,321,1920,0.3203125,0.5125,0.1671875,96685.0,29707.0,33382.0
2016-05-30_20,137634,316400,214,1125,64,1403,331,700,731,303,1734,0.40369088811995385,0.4215686274509804,0.17474048442906576,97037.0,29757.0,33520.0
2016-05-30_21,137950,317466,181,1367,69,1617,409,743,897,386,2026,0.3667324777887463,0.44274432379072065,0.19052319842053306,97382.0,29839.0,33648.0
2016-05-30_22,138144,318200,106,1031,33,1170,222,417,737,238,1392,0.2995689655172414,0.5294540229885057,0.17097701149425287,97761.0,29862.0,33686.0
2016-05-30_23,138319,318655,53,644,22,719,159,228,377,273,878,0.25968109339407747,0.4293849658314351,0.3109339407744875,97971.0,29976.0,33715.0
2016-05-31_00,138398,318869,26,299,12,337,99,129,196,111,436,0.2958715596330275,0.44954128440366975,0.2545871559633027,98078.0,30018.0,33734.0
2016-05-31_01,138445,318992,16,181,3,200,41,72,118,51,241,0.2987551867219917,0.4896265560165975,0.21161825726141079,98144.0,30028.0,33737.0
2016-05-31_02,138478,319104,16,162,2,180,29,75,88,46,209,0.3588516746411483,0.42105263157894735,0.22009569377990432,98199.0,30038.0,33743.0
2016-05-31_03,138505,319184,8,110,3,121,30,49,78,24,151,0.32450331125827814,0.5165562913907285,0.15894039735099338,98234.0,30042.0,33750.0
2016-05-31_04,138537,319296,5,191,1,197,77,76,143,55,274,0.2773722627737226,0.5218978102189781,0.20072992700729927,98302.0,30051.0,33752.0
2016-05-31_05,138607,319563,24,382,14,420,157,170,298,109,577,0.29462738301559793,0.5164644714038128,0.18890814558058924,98410.0,30089.0,33763.0
2016-05-31_06,138879,320297,102,984,37,1123,336,394,674,391,1459,0.2700479780671693,0.46196024674434544,0.26799177518848527,98667.0,30306.0,33787.0
2016-05-31_07,139292,321329,160,1362,81,1603,609,767,898,547,2212,0.34674502712477395,0.40596745027124775,0.2472875226039783,99048.0,30457.0,33930.0
2016-05-31_08,139712,322448,183,1372,78,1633,626,884,889,486,2259,0.39132359451084553,0.3935369632580788,0.2151394422310757,99312.0,30640.0,34032.0
2016-05-31_09,140091,323661,182,1583,78,1843,665,1008,1026,474,2508,0.4019138755980861,0.4090909090909091,0.18899521531100477,99684.0,30801.0,34127.0
2016-05-31_10,140555,324854,172,1650,71,1893,712,1056,1061,488,2605,0.4053742802303263,0.4072936660268714,0.1873320537428023,100151.0,30986.0,34184.0
2016-05-31_11,141027,326069,157,1640,74,1871,708,1094,1018,467,2579,0.4241954245831718,0.3947266382318728,0.1810779371849554,100571.0,31196.0,34254.0
2016-05-31_12,141456,327198,195,1427,83,1705,634,1091,852,396,2339,0.46643864899529713,0.364258230012826,0.16930312099187686,100933.0,31370.0,34329.0
2016-05-31_13,141859,328189,157,1245,75,1477,578,974,756,325,2055,0.47396593673965937,0.3678832116788321,0.15815085158150852,101201.0,31530.0,34380.0
2016-05-31_14,142232,329337,172,1558,91,1821,621,1104,969,369,2442,0.4520884520884521,0.3968058968058968,0.1511056511056511,101572.0,31795.0,34449.0
2016-05-31_15,142639,330637,215,1578,98,1891,640,1193,975,363,2531,0.4713551955748716,0.38522323192414065,0.14342157250098775,101864.0,32049.0,34508.0
2016-05-31_16,143156,332068,216,1649,112,1977,649,1117,983,526,2626,0.42536176694592537,0.3743335872048743,0.2003046458492003,102091.0,32373.0,34545.0
2016-05-31_17,143666,333360,232,1581,110,1923,806,1016,1228,485,2729,0.37229754488823746,0.44998167827042873,0.17772077684133383,102425.0,32648.0,34627.0
2016-05-31_18,144227,334804,221,1810,107,2138,733,1088,1294,489,2871,0.3789620341344479,0.4507140369209335,0.1703239289446186,102943.0,32861.0,34695.0
2016-05-31_19,144815,336346,215,1978,107,2300,733,1325,1217,491,3033,0.4368611935377514,0.4012528849324102,0.16188592152983844,103417.0,33098.0,34771.0
2016-05-31_20,145434,338037,255,2280,89,2624,881,1334,1553,618,3505,0.3805991440798859,0.44308131241084164,0.17631954350927248,104074.0,33304.0,34866.0
2016-05-31_21,145985,339917,265,2462,115,2842,786,1453,1596,579,3628,0.40049614112458654,0.43991179713340683,0.1595920617420066,104752.0,33476.0,35029.0
2016-05-31_22,146295,341112,173,1527,68,1768,413,872,971,338,2181,0.39981659789087576,0.44520861989912885,0.15497478220999542,105099.0,33593.0,35143.0
2016-05-31_23,146455,341811,95,947,23,1065,247,483,621,208,1312,0.36814024390243905,0.4733231707317073,0.15853658536585366,105331.0,33669.0,35183.0
2016-06-01_00,146525,342073,61,321,17,399,184,242,263,78,583,0.41509433962264153,0.451114922813036,0.13379073756432247,105418.0,33682.0,35196.0
2016-06-01_01,146562,342187,15,173,4,192,69,115,113,33,261,0.44061302681992337,0.4329501915708812,0.12643678160919541,105477.0,33691.0,35210.0
2016-06-01_02,146589,342266,8,119,10,137,36,71,74,28,173,0.41040462427745666,0.4277456647398844,0.16184971098265896,105504.0,33702.0,35229.0
2016-06-01_03,146613,342363,6,146,7,159,61,86,102,32,220,0.39090909090909093,0.4636363636363636,0.14545454545454545,105536.0,33712.0,35246.0
2016-06-01_04,146665,342510,17,208,16,241,92,127,146,60,333,0.3813813813813814,0.43843843843843844,0.18018018018018017,105610.0,33725.0,35263.0
2016-06-01_05,146769,342875,34,526,22,582,225,311,352,144,807,0.3853779429987608,0.436183395291202,0.17843866171003717,105740.0,33758.0,35300.0
2016-06-01_06,147000,343648,106,1095,52,1253,471,644,701,379,1724,0.37354988399071926,0.4066125290023202,0.21983758700696054,106005.0,33899.0,35386.0
2016-06-01_07,147526,345013,213,1772,93,2078,780,1177,1056,625,2858,0.4118264520643807,0.3694891532540238,0.21868439468159553,106413.0,34101.0,35467.0
2016-06-01_08,148253,346776,223,2154,99,2476,872,1445,1187,716,3348,0.4316009557945042,0.3545400238948626,0.21385902031063322,106760.0,34348.0,35537.0
2016-06-01_09,148858,348335,233,1873,75,2181,985,1361,1048,757,3166,0.42987997473152245,0.3310170562223626,0.23910296904611497,107023.0,34540.0,35663.0
2016-06-01_10,149320,349590,192,1600,98,1890,768,1176,921,561,2658,0.44243792325056436,0.34650112866817157,0.2110609480812641,107256.0,34678.0,35760.0
2016-06-01_11,149807,350809,175,1532,79,1786,747,1205,800,528,2533,0.4757204895380971,0.31583103039873667,0.2084484800631662,107531.0,34827.0,35867.0
2016-06-01_12,150322,352044,187,1522,68,1777,726,1168,768,567,2503,0.46664003196164605,0.3068318018377946,0.22652816620055932,107788.0,34976.0,35984.0
2016-06-01_13,150773,353126,160,1324,54,1538,632,1036,690,444,2170,0.4774193548387097,0.31797235023041476,0.20460829493087557,107998.0,35100.0,36045.0
2016-06-01_14,151222,354138,129,1307,76,1512,627,1013,748,378,2139,0.4735857877512856,0.34969611968209446,0.1767180925666199,108285.0,35194.0,36109.0
2016-06-01_15,151672,355315,177,1503,99,1779,637,1045,746,625,2416,0.43253311258278143,0.3087748344370861,0.2586920529801324,108535.0,35342.0,36215.0
2016-06-01_16,152132,356453,191,1455,66,1712,595,1035,767,505,2307,0.4486345903771131,0.33246640658864324,0.21889900303424362,108792.0,35497.0,36284.0
2016-06-01_17,152591,357640,221,1460,60,1741,677,956,931,531,2418,0.39536807278742764,0.3850289495450786,0.2196029776674938,109036.0,35574.0,36393.0
2016-06-01_18,152971,358809,221,1512,77,1810,599,1037,979,393,2409,0.4304690743046907,0.4063926940639269,0.16313823163138233,109410.0,35661.0,36488.0
2016-06-01_19,153343,359866,130,1451,71,1652,521,887,855,431,2173,0.4081914404049701,0.39346525540727106,0.19834330418775886,109740.0,35770.0,36565.0
2016-06-01_20,153673,361036,169,1600,67,1836,446,869,929,484,2282,0.380806310254163,0.40709903593339175,0.21209465381244522,110206.0,35849.0,36615.0
2016-06-01_21,154026,362239,204,1578,77,1859,497,927,941,488,2356,0.3934634974533107,0.39940577249575554,0.2071307300509338,110652.0,36009.0,36663.0
2016-06-01_22,154129,362556,69,459,19,547,134,242,318,121,681,0.355359765051395,0.4669603524229075,0.1776798825256975,110806.0,36039.0,36681.0
2016-06-01_23,154264,363081,110,727,22,859,245,400,499,205,1104,0.36231884057971014,0.4519927536231884,0.18568840579710144,111065.0,36090.0,36712.0
2016-06-02_00,154333,363356,41,430,16,487,98,184,289,112,585,0.3145299145299145,0.49401709401709404,0.19145299145299147,111220.0,36101.0,36731.0
2016-06-02_01,154378,363493,14,215,6,235,57,103,136,53,292,0.3527397260273973,0.4657534246575342,0.1815068493150685,111294.0,36115.0,36735.0
2016-06-02_02,154411,363564,7,122,1,130,53,78,67,38,183,0.4262295081967213,0.366120218579235,0.20765027322404372,111327.0,36125.0,36744.0
2016-06-02_03,154439,363666,9,126,6,141,24,73,51,41,165,0.44242424242424244,0.3090909090909091,0.24848484848484848,111348.0,36143.0,36749.0
2016-06-02_04,154485,363828,12,256,6,274,108,127,153,102,382,0.3324607329842932,0.4005235602094241,0.2670157068062827,111434.0,36148.0,36757.0
2016-06-02_05,154578,364123,48,451,12,511,209,244,328,148,720,0.3388888888888889,0.45555555555555555,0.20555555555555555,111590.0,36182.0,36772.0
2016-06-02_06,154796,364860,81,1146,31,1258,430,637,676,375,1688,0.3773696682464455,0.4004739336492891,0.2221563981042654,111908.0,36298.0,36857.0
2016-06-02_07,155245,366095,158,1636,75,1869,658,1059,845,623,2527,0.4190740007914523,0.334388603086664,0.24653739612188366,112277.0,36539.0,36993.0
2016-06-02_08,155753,367433,250,1745,86,2081,755,1213,846,777,2836,0.4277150916784203,0.29830747531734836,0.27397743300423133,112584.0,36715.0,37201.0
2016-06-02_09,156301,368842,220,1750,94,2064,803,1262,818,787,2867,0.4401813742588071,0.2853156609696547,0.2745029647715382,112835.0,36913.0,37377.0
2016-06-02_10,156816,370088,183,1657,81,1921,772,1114,929,650,2693,0.4136650575566283,0.3449684366877089,0.24136650575566282,113074.0,37078.0,37512.0
2016-06-02_11,157335,371286,245,1430,91,1766,765,1037,955,539,2531,0.40971947846700907,0.3773212169103121,0.21295930462267879,113298.0,37214.0,37645.0
2016-06-02_12,157796,372490,277,1487,95,1859,792,1175,905,571,2651,0.4432289701999246,0.34138061109015466,0.2153904187099208,113518.0,37336.0,37773.0
2016-06-02_13,158233,373561,186,1377,90,1653,690,971,901,471,2343,0.41442594963721724,0.3845497225778916,0.20102432778489115,113786.0,37442.0,37932.0
2016-06-02_14,158734,374791,191,1603,102,1896,608,1023,835,646,2504,0.40854632587859424,0.3334664536741214,0.25798722044728434,114210.0,37565.0,38189.0
2016-06-02_15,159133,375821,170,1378,75,1623,629,1019,791,442,2252,0.4524866785079929,0.3512433392539964,0.19626998223801065,114495.0,37680.0,38403.0
2016-06-02_16,159591,377004,189,1511,77,1777,655,951,968,513,2432,0.3910361842105263,0.3980263157894737,0.2109375,114903.0,37800.0,38526.0
2016-06-02_17,159990,378199,208,1518,81,1807,663,956,1046,468,2470,0.38704453441295544,0.4234817813765182,0.18947368421052632,115283.0,37882.0,38676.0
2016-06-02_18,160445,379607,226,1975,99,2300,694,1197,1259,538,2994,0.3997995991983968,0.42050768203072814,0.1796927187708751,115846.0,38046.0,38821.0
2016-06-02_19,161106,382171,403,3531,166,4100,1438,2025,2786,727,5538,0.3656554712892741,0.5030697002527988,0.13127482845792704,116863.0,38272.0,39209.0
2016-06-02_20,161659,384525,358,3221,116,3695,739,1866,1995,573,4434,0.4208389715832206,0.44993234100135315,0.12922868741542626,117825.0,38463.0,39502.0
2016-06-02_21,162294,386612,316,2846,103,3265,854,1607,1948,564,4119,0.3901432386501578,0.4729303228939063,0.1369264384559359,118765.0,38642.0,39722.0
2016-06-02_22,162807,388320,369,1959,85,2413,966,1441,1191,747,3379,0.4264575318141462,0.3524711453092631,0.2210713228765907,119130.0,38837.0,39925.0
2016-06-02_23,163024,389173,147,1044,30,1221,283,589,615,300,1504,0.3916223404255319,0.4089095744680851,0.19946808510638298,119396.0,38917.0,39986.0
2016-06-03_00,163130,389485,61,391,24,476,128,207,275,122,604,0.34271523178807944,0.4552980132450331,0.20198675496688742,119499.0,38938.0,40016.0
2016-06-03_01,163190,389638,21,208,5,234,60,102,130,62,294,0.3469387755102041,0.4421768707482993,0.2108843537414966,119552.0,38954.0,40028.0
2016-06-03_02,163223,389725,14,129,6,149,34,69,83,31,183,0.3770491803278688,0.453551912568306,0.16939890710382513,119581.0,38961.0,40035.0
2016-06-03_03,163265,389828,4,147,4,155,45,68,87,45,200,0.34,0.435,0.225,119613.0,38979.0,40046.0
2016-06-03_04,163300,389938,9,186,6,201,90,109,134,48,291,0.3745704467353952,0.46048109965635736,0.16494845360824742,119661.0,38987.0,40055.0
2016-06-03_05,163414,390308,34,492,19,545,191,303,284,149,736,0.4116847826086957,0.3858695652173913,0.20244565217391305,119738.0,39014.0,40091.0
2016-06-03_06,163650,391033,144,1027,50,1221,469,636,712,342,1690,0.3763313609467456,0.421301775147929,0.20236686390532543,119990.0,39106.0,40176.0
2016-06-03_07,164002,392025,154,1313,88,1555,556,854,849,408,2111,0.4045476077688299,0.40217906205589765,0.19327333017527237,120304.0,39255.0,40301.0
2016-06-03_08,164409,393211,197,1465,68,1730,670,1075,817,508,2400,0.4479166666666667,0.34041666666666665,0.21166666666666667,120573.0,39367.0,40432.0
2016-06-03_09,164855,394395,192,1450,86,1728,728,1139,738,579,2456,0.46376221498371334,0.3004885993485342,0.23574918566775244,120796.0,39482.0,40516.0
2016-06-03_10,165372,395636,217,1547,79,1843,808,1158,870,623,2651,0.43681629573745756,0.32817804602036965,0.23500565824217276,121102.0,39616.0,40697.0
2016-06-03_11,165797,396823,226,1615,111,1952,831,1139,1085,559,2783,0.4092705713259073,0.38986704994610133,0.20086237872799137,121596.0,39741.0,40815.0
2016-06-03_12,166232,397972,196,1572,83,1851,796,1019,1012,616,2647,0.38496411031356254,0.38231960710238005,0.2327162825840574,121984.0,39910.0,40928.0
2016-06-03_13,166634,398964,174,1345,56,1575,644,943,737,539,2219,0.42496620099143756,0.33213159080666965,0.24290220820189273,122372.0,40071.0,40999.0
2016-06-03_14,166997,399944,161,1423,78,1662,593,922,810,523,2255,0.4088691796008869,0.35920177383592017,0.2319290465631929,122772.0,40252.0,41083.0
2016-06-03_15,167355,400990,184,1488,63,1735,633,982,781,605,2368,0.41469594594594594,0.3298141891891892,0.25548986486486486,123168.0,40459.0,41182.0
2016-06-03_16,167691,402075,206,1418,77,1701,691,959,882,551,2392,0.40091973244147155,0.36872909698996653,0.23035117056856189,123542.0,40577.0,41423.0
2016-06-03_17,168062,403227,190,1669,73,1932,612,847,987,710,2544,0.33294025157232704,0.38797169811320753,0.27908805031446543,123978.0,40875.0,41551.0
2016-06-03_18,168507,404621,249,2246,116,2611,681,905,1837,550,3292,0.27490886998784936,0.5580194410692588,0.16707168894289187,124977.0,41032.0,41725.0
2016-06-03_19,169422,408381,477,6204,140,6821,1828,2567,4736,1346,8649,0.29679731760897216,0.5475777546537172,0.15562492773731068,128402.0,41244.0,42156.0
2016-06-03_20,170107,411555,406,5751,118,6275,1061,1879,4588,869,7336,0.25613413304252997,0.6254089422028354,0.11845692475463468,131773.0,41485.0,42296.0
2016-06-03_21,170615,413753,349,3656,81,4086,677,1261,2702,800,4763,0.2647491077052278,0.5672895234096158,0.16796136888515642,133661.0,41634.0,42393.0
2016-06-03_22,170898,414864,213,1693,53,1959,375,699,1205,430,2334,0.2994858611825193,0.5162810625535561,0.1842330762639246,134436.0,41716.0,42477.0
2016-06-03_23,171085,415574,97,1030,26,1153,253,415,675,316,1406,0.2951635846372688,0.4800853485064011,0.22475106685633,134842.0,41777.0,42519.0
2016-06-04_00,171171,415892,47,461,19,527,138,197,349,119,665,0.2962406015037594,0.524812030075188,0.17894736842105263,135047.0,41791.0,42530.0
2016-06-04_01,171215,416040,17,258,10,285,88,129,178,66,373,0.34584450402144773,0.4772117962466488,0.1769436997319035,135168.0,41819.0,42536.0
2016-06-04_02,171251,416168,13,188,7,208,39,87,121,39,247,0.3522267206477733,0.4898785425101215,0.15789473684210525,135240.0,41834.0,42542.0
2016-06-04_03,171274,416268,9,167,2,178,34,66,96,50,212,0.3113207547169811,0.4528301886792453,0.2358490566037736,135311.0,41855.0,42549.0
2016-06-04_04,171317,416443,8,266,7,281,82,79,179,105,363,0.21763085399449036,0.4931129476584022,0.2892561983471074,135403.0,41870.0,42576.0
2016-06-04_05,171381,416752,21,456,16,493,138,158,333,140,631,0.25039619651347067,0.5277337559429477,0.2218700475435816,135587.0,41893.0,42596.0
2016-06-04_06,171505,417315,58,857,36,951,256,313,646,248,1207,0.2593206296603148,0.5352112676056338,0.20546810273405136,135975.0,41922.0,42624.0
2016-06-04_07,171771,418281,145,1457,48,1650,473,657,967,499,2123,0.3094677343382007,0.45548751766368345,0.23504474799811587,136472.0,42042.0,42691.0
2016-06-04_08,172117,419414,196,1567,57,1820,596,692,1240,484,2416,0.28642384105960267,0.5132450331125827,0.20033112582781457,136964.0,42206.0,42750.0
2016-06-04_09,172457,420440,168,1343,65,1576,592,806,939,423,2168,0.37177121771217714,0.4331180811808118,0.19511070110701106,137354.0,42355.0,42804.0
2016-06-04_10,172818,421521,188,1454,64,1706,585,754,1051,486,2291,0.3291139240506329,0.45875163683980796,0.21213443910955915,137788.0,42487.0,42871.0
2016-06-04_11,173126,422573,148,1422,87,1657,631,797,1038,453,2288,0.34833916083916083,0.45367132867132864,0.1979895104895105,138275.0,42593.0,42910.0
2016-06-04_12,173420,423565,169,1343,83,1595,601,825,953,418,2196,0.3756830601092896,0.43397085610200364,0.19034608378870674,138631.0,42710.0,42942.0
2016-06-04_13,173712,424556,188,1366,61,1615,459,725,916,433,2074,0.34956605593056894,0.4416586306653809,0.20877531340405014,139041.0,42833.0,42987.0
2016-06-04_14,173993,425529,165,1396,43,1604,426,712,907,411,2030,0.35073891625615766,0.44679802955665027,0.20246305418719213,139436.0,42899.0,43099.0
2016-06-04_15,174230,426516,155,1366,52,1573,422,656,1009,330,1995,0.3288220551378446,0.505764411027569,0.16541353383458646,139801.0,42962.0,43181.0
2016-06-04_16,174553,427564,170,1327,59,1556,417,633,999,341,1973,0.32083122149011656,0.5063355296502787,0.17283324885960466,140111.0,43037.0,43240.0
2016-06-04_17,174882,428695,165,1696,52,1913,445,761,1262,335,2358,0.32273112807463955,0.5351993214588634,0.14206955046649702,140697.0,43167.0,43301.0
2016-06-04_18,175158,429774,148,1572,52,1772,346,578,1150,390,2118,0.2728989612842304,0.5429650613786591,0.18413597733711048,141185.0,43332.0,43363.0
2016-06-04_19,175432,430852,109,1492,40,1641,355,628,994,374,1996,0.31462925851703405,0.49799599198396793,0.187374749498998,141551.0,43480.0,43429.0
2016-06-04_20,175733,432002,135,1695,71,1901,349,662,950,638,2250,0.2942222222222222,0.4222222222222222,0.28355555555555556,142078.0,43619.0,43599.0
2016-06-04_21,176005,433167,160,1631,74,1865,410,691,984,600,2275,0.3037362637362637,0.43252747252747253,0.26373626373626374,142540.0,43762.0,43741.0
2016-06-04_22,176371,434358,197,1592,64,1853,347,682,985,533,2200,0.31,0.44772727272727275,0.24227272727272728,142961.0,44001.0,43811.0
2016-06-04_23,176594,435084,126,1044,32,1202,220,402,709,311,1422,0.28270042194092826,0.49859353023909986,0.21870604781997188,143274.0,44105.0,43864.0
2016-06-05_00,176717,435480,71,503,30,604,125,216,361,152,729,0.2962962962962963,0.49519890260631,0.2085048010973937,143413.0,44150.0,43894.0
2016-06-05_01,176774,435668,37,280,15,332,85,120,213,84,417,0.28776978417266186,0.5107913669064749,0.2014388489208633,143502.0,44165.0,43935.0
2016-06-05_02,176807,435780,10,169,2,181,35,72,101,43,216,0.3333333333333333,0.4675925925925926,0.19907407407407407,143546.0,44187.0,43941.0
2016-06-05_03,176837,435883,8,171,3,182,46,65,107,56,228,0.2850877192982456,0.4692982456140351,0.24561403508771928,143591.0,44201.0,43951.0
2016-06-05_04,176878,436036,12,210,7,229,60,89,122,78,289,0.3079584775086505,0.42214532871972316,0.2698961937716263,143647.0,44212.0,43977.0
2016-06-05_05,176953,436283,16,409,6,431,119,171,252,127,550,0.3109090909090909,0.4581818181818182,0.2309090909090909,143785.0,44255.0,43999.0
2016-06-05_06,177092,436779,89,803,15,907,195,304,564,234,1102,0.27586206896551724,0.5117967332123412,0.21234119782214156,144109.0,44317.0,44034.0
2016-06-05_07,177383,437716,98,1341,49,1488,454,614,905,423,1942,0.3161688980432544,0.46601441812564365,0.21781668383110195,144502.0,44482.0,44070.0
2016-06-05_08,178125,440168,289,3254,105,3648,1192,1508,2164,1168,4840,0.31157024793388427,0.4471074380165289,0.2413223140495868,145294.0,44920.0,44607.0
2016-06-05_09,178870,442603,279,3369,144,3792,905,1394,2127,1176,4697,0.29678518203108367,0.4528422397274856,0.2503725782414307,146151.0,45377.0,45253.0
2016-06-05_10,179464,444547,316,2474,101,2891,747,1154,1441,1043,3638,0.3172072567344695,0.3960967564595932,0.28669598680593733,146722.0,45710.0,45584.0
2016-06-05_11,179991,446152,280,2174,102,2556,679,1004,1358,873,3235,0.310355486862442,0.4197836166924266,0.2698608964451314,147268.0,45929.0,45868.0
2016-06-05_12,180455,447560,266,1924,70,2260,583,1059,1099,685,2843,0.3724938445304256,0.3865634892718959,0.2409426661976785,147773.0,46250.0,46091.0
2016-06-05_13,180830,448786,183,1820,91,2094,443,865,1067,605,2537,0.34095388253843123,0.4205754828537643,0.2384706346078045,148374.0,46498.0,46235.0
2016-06-05_14,181194,449910,155,1632,61,1848,434,824,856,602,2282,0.36108676599474143,0.37510955302366344,0.26380368098159507,148794.0,46774.0,46437.0
2016-06-05_15,181589,451228,213,1839,56,2108,449,944,1018,595,2557,0.369182635901447,0.3981228001564333,0.23269456394211968,149245.0,47041.0,46590.0
2016-06-05_16,181910,452451,219,1734,82,2035,380,910,967,538,2415,0.37681159420289856,0.4004140786749482,0.2227743271221532,149711.0,47273.0,46755.0
2016-06-05_17,182298,453765,207,1889,72,2168,472,983,1197,460,2640,0.3723484848484849,0.45340909090909093,0.17424242424242425,150388.0,47435.0,46893.0
2016-06-05_18,182762,455201,252,1958,102,2312,599,1186,1146,579,2911,0.40742013053933357,0.3936791480590862,0.19890072140158022,150936.0,47649.0,47018.0
2016-06-05_19,183266,456664,237,2150,63,2450,511,1264,1105,592,2961,0.42688280986153326,0.37318473488686255,0.1999324552516042,151638.0,47808.0,47193.0
2016-06-05_20,183720,458017,224,2048,93,2365,467,1140,1186,506,2832,0.4025423728813559,0.4187853107344633,0.1786723163841808,152486.0,47962.0,47313.0
2016-06-05_21,184266,459701,240,2316,88,2644,544,1099,1306,783,3188,0.34473023839397743,0.4096612296110414,0.24560853199498117,153260.0,48288.0,47486.0
2016-06-05_22,184535,460846,180,1684,79,1943,398,808,989,544,2341,0.34515164459632636,0.42246903032891925,0.23237932507475437,153817.0,48471.0,47568.0
2016-06-05_23,184710,461514,117,987,31,1135,250,497,587,301,1385,0.3588447653429603,0.42382671480144407,0.21732851985559568,154163.0,48544.0,47615.0
2016-06-06_00,184798,461830,68,498,13,579,154,224,334,175,733,0.30559345156889495,0.45566166439290584,0.23874488403819918,154377.0,48568.0,47640.0
2016-06-06_01,184840,461977,23,217,4,244,63,110,123,74,307,0.3583061889250814,0.4006514657980456,0.24104234527687296,154454.0,48581.0,47673.0
2016-06-06_02,184898,462129,13,222,2,237,110,134,110,103,347,0.3861671469740634,0.3170028818443804,0.2968299711815562,154509.0,48599.0,47691.0
2016-06-06_03,184934,462254,8,198,10,216,67,85,127,71,283,0.3003533568904594,0.44876325088339225,0.2508833922261484,154561.0,48611.0,47712.0
2016-06-06_04,184992,462453,11,326,9,346,100,156,180,110,446,0.34977578475336324,0.40358744394618834,0.24663677130044842,154664.0,48626.0,47753.0
2016-06-06_05,185112,462846,46,586,15,647,233,315,356,209,880,0.35795454545454547,0.40454545454545454,0.2375,154833.0,48687.0,47807.0
2016-06-06_06,185338,463712,109,1261,57,1427,446,609,749,515,1873,0.32514682327816335,0.399893219434063,0.2749599572877736,155152.0,48806.0,47912.0
2016-06-06_07,185752,465155,178,1907,70,2155,751,1197,977,732,2906,0.411906400550585,0.33620096352374396,0.251892635925671,155526.0,49043.0,48024.0
2016-06-06_08,186334,466777,229,1959,92,2280,893,1574,882,717,3173,0.4960605105578317,0.27797037503939487,0.2259691144027734,155855.0,49182.0,48106.0
2016-06-06_09,187050,468689,295,2356,115,2766,1161,1708,1283,936,3927,0.43493761140819964,0.3267125031830914,0.23834988540870894,156175.0,49379.0,48307.0
2016-06-06_10,187800,470567,273,2289,118,2680,1042,1655,1100,967,3722,0.4446534121440086,0.2955400322407308,0.2598065556152606,156513.0,49576.0,48476.0
2016-06-06_11,188593,472597,327,2633,139,3099,1076,2006,1344,825,4175,0.48047904191616764,0.3219161676646707,0.19760479041916168,157071.0,50036.0,48597.0
2016-06-06_12,189352,474528,308,2471,120,2899,1028,1875,1292,760,3927,0.4774637127578304,0.329004329004329,0.19353195823784058,157593.0,50319.0,48704.0
2016-06-06_13,189987,476256,236,2314,92,2642,923,1689,1203,673,3565,0.4737727910238429,0.3374474053295933,0.18877980364656383,158084.0,50601.0,48808.0
2016-06-06_14,190628,477889,293,2201,112,2606,796,1479,1239,684,3402,0.4347442680776014,0.36419753086419754,0.20105820105820105,158607.0,50862.0,48925.0
2016-06-06_15,191201,479563,275,2359,107,2741,867,1570,1264,774,3608,0.4351441241685144,0.35033259423503327,0.21452328159645231,159172.0,51229.0,49145.0
2016-06-06_16,191805,481401,358,2297,99,2754,818,1664,1147,761,3572,0.4658454647256439,0.32110862262038076,0.21304591265397538,159638.0,51492.0,49346.0
2016-06-06_17,192333,483022,268,2196,87,2551,796,1461,1162,724,3347,0.4365103077382731,0.3471765760382432,0.2163131162234837,160124.0,51723.0,49513.0
2016-06-06_18,193243,485011,320,2635,101,3056,1596,2427,1437,788,4652,0.5217110920034393,0.3088993981083405,0.16938950988822013,160726.0,51942.0,49665.0
2016-06-06_19,194301,487582,338,3402,120,3860,769,2138,1693,798,4629,0.4618708144307626,0.36573774033268525,0.17239144523655217,161612.0,52271.0,49779.0
2016-06-06_20,195070,489601,264,2745,97,3106,610,1683,1329,704,3716,0.45290635091496234,0.3576426264800861,0.18945102260495156,162257.0,52530.0,49926.0
2016-06-06_21,195820,492048,245,3382,128,3755,811,1949,1622,995,4566,0.42685063512921595,0.35523434077967586,0.2179150240911082,163023.0,52887.0,50232.0
2016-06-06_22,196308,493695,279,2056,95,2430,470,1333,940,627,2900,0.4596551724137931,0.32413793103448274,0.21620689655172415,163395.0,53098.0,50430.0
2016-06-06_23,196565,494415,96,929,40,1065,224,569,458,262,1289,0.44142746314972847,0.35531419705197825,0.20325833979829325,163635.0,53187.0,50484.0
2016-06-07_00,196741,494809,57,554,24,635,131,354,289,123,766,0.4621409921671018,0.3772845953002611,0.16057441253263707,163860.0,53214.0,50502.0
2016-06-07_01,196821,494991,19,295,12,326,78,191,134,79,404,0.47277227722772275,0.3316831683168317,0.19554455445544555,163946.0,53256.0,50517.0
2016-06-07_02,196885,495132,10,207,3,220,61,142,97,42,281,0.505338078291815,0.34519572953736655,0.1494661921708185,164015.0,53277.0,50527.0
2016-06-07_03,196978,495302,13,238,2,253,93,179,85,82,346,0.5173410404624278,0.24566473988439305,0.23699421965317918,164068.0,53300.0,50551.0
2016-06-07_04,197062,495543,12,375,8,395,106,193,172,136,501,0.3852295409181637,0.34331337325349304,0.2714570858283433,164145.0,53349.0,50582.0
2016-06-07_05,197255,496090,74,755,29,858,308,496,405,265,1166,0.42538593481989706,0.34734133790737565,0.22727272727272727,164299.0,53421.0,50627.0
2016-06-07_06,197696,497274,152,1595,75,1822,688,1158,813,539,2510,0.4613545816733068,0.32390438247011955,0.2147410358565737,164628.0,53671.0,50707.0
2016-06-07_07,198539,499479,257,2741,110,3108,943,2182,1140,729,4051,0.538632436435448,0.2814119970377685,0.17995556652678352,165062.0,54028.0,50876.0
2016-06-07_08,199292,501366,243,2441,119,2803,1063,1991,1011,864,3866,0.5150025866528711,0.26151060527677183,0.22348680807035695,165459.0,54346.0,50984.0
2016-06-07_09,200218,503392,255,2532,149,2936,987,2027,1084,812,3923,0.5166964058118787,0.2763191435126179,0.20698445067550345,165949.0,54530.0,51081.0
2016-06-07_10,201061,505315,267,2494,120,2881,1061,2157,1071,714,3942,0.5471841704718418,0.271689497716895,0.1811263318112633,166556.0,54704.0,51212.0
2016-06-07_11,201955,507263,227,2552,132,2911,1068,2149,1065,765,3979,0.5400854486051772,0.26765518974616737,0.19225936164865545,167160.0,54866.0,51369.0
2016-06-07_12,202788,509227,294,2561,116,2971,1049,2002,1170,848,4020,0.4980099502487562,0.291044776119403,0.2109452736318408,167785.0,55047.0,51563.0
2016-06-07_13,203618,510895,240,2311,81,2632,922,1721,1153,680,3554,0.48424310635903206,0.32442318514350027,0.19133370849746764,168374.0,55237.0,51815.0
2016-06-07_14,204287,512518,254,2202,84,2540,846,1661,1125,600,3386,0.49054932073242763,0.33225044300059065,0.1772002362669817,168852.0,55342.0,52022.0
2016-06-07_15,205059,514381,228,2486,75,2789,821,1913,1203,494,3610,0.5299168975069252,0.3332409972299169,0.1368421052631579,169393.0,55615.0,52290.0
2016-06-07_16,205844,516432,294,2771,108,3173,791,1813,1437,714,3964,0.45736629667003026,0.3625126135216953,0.18012108980827446,170120.0,55900.0,52664.0
2016-06-07_17,206581,518455,292,2795,103,3190,938,1781,1639,708,4128,0.4314437984496124,0.39704457364341084,0.17151162790697674,170819.0,56098.0,52906.0
2016-06-07_18,207255,520388,310,2763,115,3188,1021,1873,1573,763,4209,0.44499881206937514,0.37372297457828463,0.18127821335234023,171648.0,56330.0,53102.0
2016-06-07_19,208096,522738,352,3350,133,3835,975,2369,1752,689,4810,0.4925155925155925,0.36424116424116426,0.14324324324324325,172624.0,56707.0,53421.0
2016-06-07_20,210129,527199,800,6292,232,7324,3290,3646,5445,1523,10614,0.34350857358206144,0.5130016958733747,0.1434897305445638,175379.0,57264.0,53798.0
2016-06-07_21,211799,531429,765,5842,252,6859,1697,3188,4253,1115,8556,0.37260402057035996,0.49707807386629266,0.13031790556334735,177744.0,57809.0,54184.0
2016-06-07_22,212817,534263,391,3654,135,4180,778,2190,2026,742,4958,0.4417103670835014,0.40863251311012505,0.14965711980637353,178820.0,58466.0,54449.0
2016-06-07_23,213119,535367,188,1439,43,1670,330,669,989,342,2000,0.3345,0.4945,0.171,179319.0,58666.0,54534.0
2016-06-08_00,213258,535878,79,674,34,787,162,328,431,190,949,0.34562697576396206,0.4541622760800843,0.20021074815595363,179561.0,58738.0,54562.0
2016-06-08_01,213330,536085,26,302,9,337,93,166,187,77,430,0.386046511627907,0.43488372093023253,0.17906976744186046,179649.0,58758.0,54584.0
2016-06-08_02,213388,536236,26,239,4,269,54,113,146,64,323,0.3498452012383901,0.4520123839009288,0.19814241486068113,179749.0,58775.0,54600.0
2016-06-08_03,213432,536362,10,181,6,197,54,86,110,55,251,0.3426294820717131,0.43824701195219123,0.21912350597609562,179812.0,58790.0,54609.0
2016-06-08_04,213500,536597,34,364,15,413,104,172,255,90,517,0.33268858800773693,0.4932301740812379,0.17408123791102514,179946.0,58808.0,54628.0
2016-06-08_05,213667,537177,59,892,37,988,261,410,551,288,1249,0.32826261008807045,0.4411529223378703,0.23058446757405926,180178.0,58876.0,54728.0
2016-06-08_06,214027,538476,181,1964,62,2207,570,951,1289,537,2777,0.34245588764854157,0.46416996759092544,0.19337414476053294,180811.0,59097.0,54827.0
2016-06-08_07,214571,540183,294,2331,90,2715,803,1333,1421,764,3518,0.3789084707220011,0.4039226833428084,0.21716884593519045,181496.0,59325.0,54910.0
2016-06-08_08,215126,541909,304,2166,111,2581,899,1454,1253,773,3480,0.417816091954023,0.3600574712643678,0.2221264367816092,182057.0,59545.0,55016.0
2016-06-08_09,215704,543500,260,1989,119,2368,1026,1484,1180,730,3394,0.43724219210371246,0.34767236299351795,0.2150854449027696,182445.0,59762.0,55077.0
2016-06-08_10,216648,545443,261,2635,154,3050,1572,2456,1385,781,4622,0.531371700562527,0.2996538295110342,0.16897446992643878,183068.0,60007.0,55397.0
2016-06-08_11,217598,547538,270,2815,149,3234,1610,2615,1466,763,4844,0.5398431048720066,0.3026424442609414,0.157514450867052,183674.0,60286.0,55751.0
2016-06-08_12,218348,549489,251,2592,113,2956,1070,2245,1161,620,4026,0.557625434674615,0.28837555886736216,0.15399900645802286,184231.0,60423.0,55951.0
2016-06-08_13,218710,550359,102,1182,41,1325,487,869,589,354,1812,0.4795805739514349,0.3250551876379691,0.19536423841059603,184540.0,60499.0,55998.0
2016-06-08_14,219251,551858,153,1817,108,2078,679,1706,722,329,2757,0.6187885382662314,0.2618788538266231,0.11933260790714545,184846.0,60540.0,56099.0
2016-06-08_15,220288,554282,288,3000,126,3414,997,2587,1131,693,4411,0.5864883246429381,0.2564044434368624,0.1571072319201995,185370.0,60910.0,56260.0
2016-06-08_16,221017,556109,235,2350,104,2689,861,1888,1090,572,3550,0.5318309859154929,0.30704225352112674,0.1611267605633803,185789.0,61160.0,56430.0
2016-06-08_17,221712,557832,260,2337,105,2702,829,1700,1322,509,3531,0.48145001416029454,0.37439818748229964,0.14415179835740582,186408.0,61348.0,56632.0
2016-06-08_18,222474,560126,398,3545,146,4089,1478,2064,2490,1013,5567,0.37075624214118913,0.4472786060714927,0.18196515178731812,187642.0,61525.0,56824.0
2016-06-08_19,223080,562317,369,3369,139,3877,876,1628,2372,753,4753,0.3425205133599832,0.49905322953923836,0.15842625710077846,188923.0,61724.0,56996.0
2016-06-08_20,223557,563987,249,2524,116,2889,681,1161,1793,616,3570,0.32521008403361346,0.5022408963585434,0.17254901960784313,189904.0,61880.0,57120.0
2016-06-08_21,224173,566045,313,2722,141,3176,865,1464,1755,822,4041,0.36228656273199705,0.43429844097995546,0.20341499628804752,190684.0,62001.0,57328.0
2016-06-08_22,224568,567789,220,2258,101,2579,534,1041,1436,636,3113,0.3344041117892708,0.4612913588178606,0.2043045293928686,191135.0,62126.0,57552.0
2016-06-08_23,224755,568514,144,958,51,1153,283,504,638,294,1436,0.35097493036211697,0.44428969359331477,0.20473537604456823,191392.0,62182.0,57600.0
2016-06-09_00,224843,568874,69,482,21,572,136,236,333,139,708,0.3333333333333333,0.4703389830508475,0.1963276836158192,191536.0,62199.0,57634.0
2016-06-09_01,224884,569057,20,266,2,288,71,129,158,72,359,0.3593314763231198,0.4401114206128134,0.20055710306406685,191618.0,62207.0,57659.0
2016-06-09_02,224915,569175,17,182,4,203,72,87,149,39,275,0.31636363636363635,0.5418181818181819,0.14181818181818182,191686.0,62213.0,57674.0
2016-06-09_03,224948,569294,19,186,14,219,78,92,164,41,297,0.30976430976430974,0.5521885521885522,0.13804713804713806,191751.0,62215.0,57710.0
2016-06-09_04,224999,569506,14,372,14,400,132,177,249,106,532,0.33270676691729323,0.4680451127819549,0.19924812030075187,191904.0,62225.0,57755.0
2016-06-09_05,225131,570045,84,781,35,900,343,416,567,260,1243,0.33467417538214,0.4561544650040225,0.20917135961383748,192105.0,62259.0,57820.0
2016-06-09_06,225517,571420,208,1963,90,2261,763,1059,1277,688,3024,0.3501984126984127,0.42228835978835977,0.2275132275132275,192667.0,62355.0,58044.0
2016-06-09_07,226051,573295,274,2481,126,2881,986,1637,1506,724,3867,0.4233255753814326,0.3894491854150504,0.18722523920351694,193256.0,62621.0,58266.0
2016-06-09_08,226640,575284,277,2764,108,3149,1122,1779,1602,890,4271,0.41653008663076563,0.37508780145165066,0.2083821119175837,193900.0,62816.0,58439.0
2016-06-09_09,227246,577178,301,2456,131,2888,1090,1786,1330,862,3978,0.4489693313222725,0.33433886375062843,0.21669180492709905,194405.0,62983.0,58547.0
2016-06-09_10,227834,578924,287,2462,125,2874,1136,1713,1354,943,4010,0.42718204488778055,0.3376558603491272,0.23516209476309227,194974.0,63191.0,58750.0
2016-06-09_11,228380,580639,290,2558,144,2992,1187,1553,1699,927,4179,0.37162000478583396,0.4065565924862407,0.22182340272792533,195798.0,63372.0,58953.0
2016-06-09_12,228938,582347,320,2255,124,2699,1109,1631,1276,901,3808,0.42830882352941174,0.33508403361344535,0.23660714285714285,196322.0,63553.0,59201.0
2016-06-09_13,229359,583688,278,1898,103,2279,955,1306,1158,770,3234,0.4038342609771181,0.3580705009276438,0.23809523809523808,196847.0,63678.0,59342.0
2016-06-09_14,229857,585204,235,2085,113,2433,851,1398,1225,661,3284,0.42570036540803896,0.37302070645554203,0.201278928136419,197370.0,63775.0,59546.0
2016-06-09_15,230310,586584,246,1999,108,2353,879,1325,1193,714,3232,0.4099628712871287,0.3691212871287129,0.22091584158415842,197929.0,63887.0,59684.0
2016-06-09_16,230746,588127,263,2250,104,2617,896,1414,1220,879,3513,0.40250498149729574,0.34728152576145743,0.2502134927412468,198574.0,64057.0,59788.0
2016-06-09_17,231263,589848,289,2548,99,2936,1148,1662,1474,948,4084,0.4069539666993144,0.36092066601371203,0.23212536728697356,199158.0,64317.0,59899.0
2016-06-09_18,231801,591694,316,2714,142,3172,1160,1696,1713,923,4332,0.3915050784856879,0.3954293628808864,0.21306555863342566,199829.0,64531.0,60013.0
2016-06-09_19,233106,595031,717,4812,190,5719,3439,2915,4613,1630,9158,0.3183009390696659,0.5037126010045861,0.177986459925748,201252.0,64798.0,60255.0
2016-06-09_20,234713,599810,914,6952,220,8086,3236,3649,5896,1777,11322,0.3222928811164105,0.5207560501678149,0.1569510687157746,203635.0,65177.0,60723.0
2016-06-09_21,235911,604217,656,6141,215,7012,1759,3318,4269,1184,8771,0.37829209896249,0.48671759206475884,0.1349903089727511,205372.0,65584.0,61415.0
2016-06-09_22,237140,607880,686,4350,165,5201,1917,2987,2753,1378,7118,0.41964034841247544,0.38676594549030624,0.19359370609721832,206321.0,66212.0,61767.0
2016-06-09_23,237512,609478,266,1950,88,2304,534,1075,1234,529,2838,0.3787878787878788,0.43481324876673716,0.18639887244538408,206765.0,66313.0,61952.0
2016-06-10_00,237647,610004,83,719,30,832,186,350,485,183,1018,0.343811394891945,0.4764243614931238,0.17976424361493124,206977.0,66334.0,62015.0
2016-06-10_01,237742,610284,76,409,12,497,112,217,282,110,609,0.3563218390804598,0.4630541871921182,0.180623973727422,207088.0,66343.0,62103.0
2016-06-10_02,237812,610478,23,280,3,306,69,126,149,100,375,0.336,0.3973333333333333,0.26666666666666666,207147.0,66354.0,62148.0
2016-06-10_03,237856,610614,6,208,5,219,72,110,106,75,291,0.37800687285223367,0.3642611683848797,0.25773195876288657,207195.0,66364.0,62179.0
2016-06-10_04,237934,610887,24,471,10,505,145,193,269,188,650,0.2969230769230769,0.41384615384615386,0.28923076923076924,207334.0,66377.0,62253.0
2016-06-10_05,238113,611550,56,986,19,1061,300,487,512,362,1361,0.35782512858192506,0.3761939750183688,0.2659808963997061,207603.0,66445.0,62410.0
2016-06-10_06,238453,613056,200,2041,69,2310,688,1013,1436,549,2998,0.337891927951968,0.4789859906604403,0.18312208138759173,208130.0,66719.0,62542.0
2016-06-10_07,238971,614998,257,2853,97,3207,908,1379,1745,991,4115,0.3351154313487242,0.4240583232077764,0.2408262454434994,208960.0,67091.0,62715.0
2016-06-10_08,239491,616899,286,2641,107,3034,976,1754,1482,774,4010,0.4374064837905237,0.36957605985037406,0.19301745635910225,209674.0,67349.0,62844.0
2016-06-10_09,239961,618507,324,2323,112,2759,1046,1525,1356,924,3805,0.4007884362680683,0.3563731931668857,0.24283837056504598,210327.0,67569.0,62930.0
2016-06-10_10,240491,620245,318,2204,130,2652,1208,1529,1143,1188,3860,0.3961139896373057,0.2961139896373057,0.3077720207253886,210700.0,67983.0,63018.0
2016-06-10_11,241007,621801,295,2165,89,2549,1030,1364,1305,910,3579,0.38111204246996366,0.36462699077954736,0.254260966750489,211176.0,68298.0,63082.0
2016-06-10_12,241510,623388,293,2227,115,2635,1027,1399,1434,829,3662,0.3820316766794102,0.3915892954669579,0.2263790278536319,211728.0,68686.0,63177.0
2016-06-10_13,241934,624789,287,1921,97,2305,896,1350,1179,672,3201,0.4217432052483599,0.3683223992502343,0.2099343955014058,212170.0,68933.0,63286.0
2016-06-10_14,242347,626183,220,1970,125,2315,833,1293,1180,675,3148,0.4107369758576874,0.3748411689961881,0.21442185514612452,212728.0,69123.0,63402.0
2016-06-10_15,242803,627708,233,2271,106,2610,896,1462,1402,642,3506,0.416999429549344,0.39988590986879635,0.18311466058185966,213442.0,69320.0,63483.0
2016-06-10_16,243362,629517,264,2643,89,2996,883,1681,1542,656,3879,0.43335911317349834,0.39752513534416084,0.16911575148234081,214184.0,69490.0,63600.0
2016-06-10_17,243972,631551,291,3004,109,3404,806,1572,1748,890,4210,0.373396674584323,0.4152019002375297,0.21140142517814728,215163.0,69810.0,63730.0
2016-06-10_18,244732,633777,347,3208,124,3679,1108,1740,2029,1018,4787,0.36348443701692085,0.4238562774180071,0.21265928556507208,216150.0,70191.0,63852.0
2016-06-10_19,245347,636086,378,3519,98,3995,846,1447,2411,983,4841,0.2989051848791572,0.49803759553811194,0.20305721958273085,217503.0,70471.0,64002.0
2016-06-10_20,245890,638274,399,3084,116,3599,710,1391,1918,1000,4309,0.32281271756788116,0.44511487584126247,0.23207240659085634,218466.0,70740.0,64152.0
2016-06-10_21,246510,640501,416,3541,142,4099,955,1572,2371,1111,5054,0.3110407597942224,0.4691333597150772,0.21982588049070043,219781.0,70957.0,64513.0
2016-06-10_22,246901,642165,242,2412,104,2758,562,1001,1549,770,3320,0.30150602409638555,0.46656626506024096,0.2319277108433735,220598.0,71083.0,64633.0
2016-06-10_23,247137,643132,166,1523,55,1744,412,590,1092,474,2156,0.27365491651205937,0.5064935064935064,0.21985157699443414,221216.0,71147.0,64703.0
2016-06-11_00,247248,643625,97,762,35,894,196,361,496,233,1090,0.3311926605504587,0.45504587155963305,0.21376146788990827,221535.0,71178.0,64744.0
2016-06-11_01,247331,643892,48,369,14,431,103,163,249,122,534,0.3052434456928839,0.46629213483146065,0.22846441947565543,221650.0,71195.0,64749.0
2016-06-11_02,247380,644041,19,211,6,236,78,92,142,80,314,0.2929936305732484,0.45222929936305734,0.25477707006369427,221731.0,71206.0,64760.0
2016-06-11_03,247418,644170,26,190,5,221,68,80,136,73,289,0.2768166089965398,0.47058823529411764,0.25259515570934254,221799.0,71218.0,64765.0
2016-06-11_04,247466,644373,20,315,7,342,86,121,228,79,428,0.2827102803738318,0.5327102803738317,0.18457943925233644,221929.0,71232.0,64778.0
2016-06-11_05,247570,644767,28,688,17,733,205,253,468,217,938,0.2697228144989339,0.4989339019189765,0.23134328358208955,222278.0,71266.0,64793.0
2016-06-11_06,247786,645696,114,1340,57,1511,467,571,986,421,1978,0.28867542972699695,0.49848331648129424,0.2128412537917088,222702.0,71341.0,64847.0
2016-06-11_07,248144,647018,178,1826,72,2076,529,907,1151,547,2605,0.3481765834932822,0.4418426103646833,0.20998080614203454,223111.0,71616.0,64966.0
2016-06-11_08,248418,647917,131,1217,76,1424,374,644,826,328,1798,0.3581757508342603,0.4593993325917686,0.18242491657397109,223432.0,71802.0,65020.0
2016-06-11_09,249131,650120,332,2925,135,3392,845,1481,1806,950,4237,0.3495397687042719,0.4262449846589568,0.2242152466367713,224211.0,72177.0,65118.0
2016-06-11_10,249735,652089,333,2794,131,3258,951,1465,1882,862,4209,0.34806367308149205,0.4471370871941079,0.2047992397244001,225106.0,72435.0,65217.0
2016-06-11_11,250258,654022,307,2600,106,3013,921,1354,1760,820,3934,0.344178952719878,0.44738179969496694,0.20843924758515506,225788.0,72667.0,65271.0
2016-06-11_12,250751,655788,316,2288,102,2706,830,1196,1539,801,3536,0.3382352941176471,0.435237556561086,0.22652714932126697,226341.0,72888.0,65342.0
2016-06-11_13,251200,657586,305,2346,116,2767,690,1208,1412,837,3457,0.3494359271044258,0.40844663002603415,0.24211744286954007,226809.0,73047.0,65428.0
2016-06-11_14,251658,659213,308,2166,88,2562,655,991,1553,673,3217,0.30805097917314267,0.48274790177183713,0.2092011190550202,227246.0,73208.0,65525.0
2016-06-11_15,252064,660846,280,2183,87,2550,668,1040,1452,726,3218,0.32318210068365444,0.4512119328775637,0.22560596643878186,227644.0,73438.0,65656.0
2016-06-11_16,252445,662322,252,2047,85,2384,567,810,1492,649,2951,0.27448322602507624,0.5055913249745849,0.21992544900033886,228156.0,73600.0,65726.0
2016-06-11_17,253006,664087,243,2427,95,2765,562,895,1804,628,3327,0.2690111211301473,0.5422302374511572,0.18875864141869553,228737.0,73740.0,65862.0
2016-06-11_18,253439,665707,231,2370,86,2687,628,988,1673,654,3315,0.2980392156862745,0.5046757164404223,0.19728506787330316,229466.0,73938.0,65939.0
2016-06-11_19,253982,667472,234,2529,93,2856,543,1077,1667,655,3399,0.31685789938217124,0.490438364224772,0.19270373639305677,230263.0,74121.0,65987.0
2016-06-11_20,254506,669140,219,2526,89,2834,550,892,1859,633,3384,0.2635933806146572,0.5493498817966903,0.1870567375886525,231143.0,74334.0,66039.0
2016-06-11_21,254911,670748,321,2234,107,2662,552,947,1620,647,3214,0.29464841319228374,0.5040448039825762,0.20130678282514,231936.0,74477.0,66115.0
2016-06-11_22,255270,672108,266,1922,122,2310,441,739,1467,545,2751,0.26862958924027625,0.5332606324972737,0.19810977826245002,232636.0,74587.0,66284.0
2016-06-11_23,255445,672891,200,1004,61,1265,301,468,800,298,1566,0.2988505747126437,0.5108556832694764,0.19029374201787994,232923.0,74644.0,66342.0
2016-06-12_00,255568,673336,82,552,31,665,142,219,402,186,807,0.27137546468401486,0.49814126394052044,0.23048327137546468,233069.0,74663.0,66374.0
2016-06-12_01,255640,673540,43,278,18,339,108,124,243,80,447,0.27740492170022374,0.5436241610738255,0.1789709172259508,233166.0,74669.0,66398.0
2016-06-12_02,255682,673677,37,196,12,245,72,89,141,87,317,0.2807570977917981,0.444794952681388,0.2744479495268139,233226.0,74686.0,66419.0
2016-06-12_03,255714,673807,14,176,5,195,84,79,126,74,279,0.2831541218637993,0.45161290322580644,0.26523297491039427,233287.0,74695.0,66424.0
2016-06-12_04,255769,673980,12,261,5,278,76,102,154,98,354,0.288135593220339,0.4350282485875706,0.2768361581920904,233370.0,74715.0,66446.0
2016-06-12_05,255833,674255,29,406,18,453,163,188,317,111,616,0.3051948051948052,0.5146103896103896,0.18019480519480519,233487.0,74729.0,66473.0
2016-06-12_06,255981,674937,89,927,45,1061,311,443,655,274,1372,0.3228862973760933,0.4774052478134111,0.19970845481049562,233705.0,74787.0,66505.0
2016-06-12_07,256291,676293,217,1821,86,2124,568,833,1253,606,2692,0.30943536404160477,0.46545319465081725,0.22511144130757801,234171.0,74886.0,66584.0
2016-06-12_08,256995,679091,549,3791,199,4539,1390,1726,3046,1157,5929,0.29111148591668073,0.5137459942654747,0.1951425198178445,235166.0,75180.0,66896.0
2016-06-12_09,257846,682178,502,4590,182,5274,1080,1822,3057,1475,6354,0.2867485048788165,0.48111425873465535,0.23213723638652817,236657.0,75539.0,67316.0
2016-06-12_10,258423,684508,436,3131,142,3709,994,1494,2121,1088,4703,0.3176695726132256,0.45098873059749095,0.23134169678928343,237547.0,75776.0,67484.0
2016-06-12_11,258903,686538,399,2852,140,3391,773,1286,1868,1010,4164,0.30883765609990393,0.44860710854947167,0.2425552353506244,238429.0,76090.0,67594.0
2016-06-12_12,259448,688524,315,2753,109,3177,701,1248,1736,894,3878,0.3218153687467767,0.44765342960288806,0.23053120165033522,239127.0,76322.0,67725.0
2016-06-12_13,259869,690152,235,2299,85,2619,598,1080,1438,699,3217,0.335716506061548,0.44700031084861674,0.21728318308983524,239639.0,76577.0,67805.0
2016-06-12_14,260251,691566,276,2072,107,2455,593,929,1478,641,3048,0.30479002624671914,0.4849081364829396,0.2103018372703412,240200.0,76771.0,67947.0
2016-06-12_15,260625,693127,222,2154,96,2472,572,910,1455,679,3044,0.29894875164257556,0.4779894875164258,0.22306176084099869,240747.0,76906.0,68026.0
2016-06-12_16,261057,694967,262,2452,102,2816,551,979,1688,700,3367,0.29076329076329077,0.5013365013365013,0.2079002079002079,241310.0,77061.0,68156.0
2016-06-12_17,261530,696703,255,2304,79,2638,531,876,1709,584,3169,0.2764278952350899,0.5392868412748502,0.18428526349005997,241877.0,77186.0,68226.0
2016-06-12_18,261963,698276,238,2310,83,2631,581,951,1600,661,3212,0.2960772104607721,0.49813200498132004,0.20579078455790784,242589.0,77322.0,68288.0
2016-06-12_19,262394,699940,256,2494,99,2849,482,976,1774,581,3331,0.29300510357250076,0.5325728009606725,0.17442209546682677,243464.0,77464.0,68417.0
2016-06-12_20,262802,701814,251,2720,119,3090,488,1043,1747,788,3578,0.29150363331470097,0.4882615986584684,0.22023476802683062,244252.0,77686.0,68472.0
2016-06-12_21,263231,703486,278,2345,100,2723,659,1164,1571,647,3382,0.34417504435245416,0.46451803666469543,0.19130691898285038,244938.0,77826.0,68550.0
2016-06-12_22,263603,704718,252,1699,90,2041,567,832,1266,510,2608,0.31901840490797545,0.4854294478527607,0.1955521472392638,245485.0,77883.0,68587.0
2016-06-12_23,263757,705286,94,765,31,890,209,337,497,265,1099,0.30664240218380345,0.45222929936305734,0.2411282984531392,245671.0,77932.0,68630.0
2016-06-13_00,263831,705566,73,351,15,439,98,190,247,100,537,0.3538175046554935,0.45996275605214154,0.186219739292365,245762.0,77941.0,68647.0
2016-06-13_01,263863,705723,32,233,9,274,71,125,158,62,345,0.36231884057971014,0.4579710144927536,0.17971014492753623,245831.0,77959.0,68664.0
2016-06-13_02,263892,705827,11,152,0,163,59,87,87,48,222,0.3918918918918919,0.3918918918918919,0.21621621621621623,245866.0,77967.0,68674.0
2016-06-13_03,263919,705929,5,158,0,163,39,60,80,62,202,0.297029702970297,0.39603960396039606,0.3069306930693069,245903.0,77977.0,68677.0
2016-06-13_04,263971,706112,11,260,6,277,75,130,169,53,352,0.3693181818181818,0.48011363636363635,0.15056818181818182,245976.0,77980.0,68720.0
2016-06-13_05,264058,706501,40,564,26,630,198,294,355,179,828,0.35507246376811596,0.428743961352657,0.21618357487922704,246152.0,78031.0,68749.0
2016-06-13_06,264246,707364,94,1324,42,1460,504,611,884,469,1964,0.31109979633401225,0.45010183299389,0.23879837067209775,246499.0,78086.0,68802.0
2016-06-13_07,264587,708727,245,2024,97,2366,750,1019,1286,811,3116,0.32702182284980746,0.4127086007702182,0.26026957637997433,247048.0,78259.0,68897.0
2016-06-13_08,264985,710220,268,1976,111,2355,798,1048,1245,860,3153,0.33238185854741514,0.3948620361560419,0.272756105296543,247474.0,78394.0,69050.0
2016-06-13_09,265486,711818,274,2238,108,2620,985,1347,1341,917,3605,0.37364771151178916,0.37198335644937586,0.2543689320388349,248038.0,78615.0,69233.0
2016-06-13_10,265927,713347,277,2189,111,2577,1033,1385,1414,811,3610,0.38365650969529086,0.39168975069252077,0.22465373961218837,248511.0,78752.0,69368.0
2016-06-13_11,266386,714953,297,2430,143,2870,1072,1380,1729,833,3942,0.350076103500761,0.43860984271943176,0.2113140537798072,249170.0,78898.0,69475.0
2016-06-13_12,266970,716929,327,2822,153,3302,1206,1584,1707,1217,4508,0.3513753327417924,0.3786601597160603,0.2699645075421473,249846.0,79235.0,69579.0
2016-06-13_13,267508,718749,257,2613,116,2986,887,1367,1590,916,3873,0.35295636457526464,0.41053446940356314,0.23650916602117222,250449.0,79497.0,69674.0
2016-06-13_14,267979,720359,253,2611,130,2994,924,1433,1641,844,3918,0.3657478305257785,0.41883614088820825,0.21541602858601328,251229.0,79787.0,69801.0
2016-06-13_15,268431,722167,304,2717,103,3124,953,1522,1585,970,4077,0.3733137110620554,0.388766249693402,0.23792003924454255,251976.0,80100.0,69960.0
2016-06-13_16,268951,724184,299,3231,156,3686,941,1527,2088,1012,4627,0.33001945104819536,0.45126431813269935,0.21871623081910524,252913.0,80320.0,70192.0
2016-06-13_17,269330,725968,284,2756,127,3167,899,1394,1941,731,4066,0.3428430890309887,0.47737333989178554,0.17978357107722578,253741.0,80461.0,70349.0
2016-06-13_18,269741,727672,313,2472,118,2903,803,1326,1596,784,3706,0.3577981651376147,0.4306529951430113,0.211548839719374,254439.0,80610.0,70567.0
2016-06-13_19,270231,729618,334,2919,133,3386,799,1266,2020,899,4185,0.3025089605734767,0.4826762246117085,0.21481481481481482,255298.0,80828.0,70718.0
2016-06-13_20,270705,731698,290,3493,154,3937,678,1474,2361,780,4615,0.3193932827735645,0.5115926327193933,0.16901408450704225,256688.0,81038.0,70923.0
2016-06-13_21,271605,735545,449,5678,296,6423,1103,2554,3344,1628,7526,0.33935689609354236,0.44432633537071486,0.21631676853574275,258356.0,81254.0,71547.0
2016-06-13_22,272390,738410,313,3666,140,4119,739,1727,2075,1056,4858,0.35549608892548373,0.42713050638122685,0.21737340469328942,259086.0,81384.0,71918.0
2016-06-13_23,272730,739742,186,1748,49,1983,367,792,958,600,2350,0.33702127659574466,0.4076595744680851,0.2553191489361702,259411.0,81592.0,72053.0
2016-06-14_00,272888,740311,86,820,22,928,218,365,485,296,1146,0.31849912739965097,0.4232111692844677,0.2582897033158813,259608.0,81698.0,72140.0
2016-06-14_01,272983,740608,37,427,9,473,118,214,231,146,591,0.36209813874788493,0.39086294416243655,0.2470389170896785,259706.0,81732.0,72178.0
2016-06-14_02,273067,740809,20,300,10,330,102,133,207,92,432,0.30787037037037035,0.4791666666666667,0.21296296296296297,259786.0,81752.0,72208.0
2016-06-14_03,273127,740973,16,262,4,282,99,115,188,78,381,0.30183727034120733,0.49343832020997375,0.2047244094488189,259872.0,81785.0,72232.0
2016-06-14_04,273204,741309,16,541,14,571,180,200,321,230,751,0.2663115845539281,0.4274300932090546,0.3062583222370173,259989.0,81856.0,72281.0
2016-06-14_05,273470,742320,87,1424,39,1550,395,604,796,545,1945,0.31053984575835475,0.40925449871465297,0.2802056555269923,260264.0,82096.0,72387.0
2016-06-14_06,274094,744673,217,3187,121,3525,1010,1531,1629,1375,4535,0.33759647188533626,0.35920617420066153,0.3031973539140022,260832.0,82725.0,72566.0
2016-06-14_07,275126,748265,387,4298,176,4861,1479,2182,2316,1842,6340,0.3441640378548896,0.36529968454258677,0.29053627760252365,261461.0,83490.0,72758.0
2016-06-14_08,276166,751766,423,4342,175,4940,1658,2372,2371,1855,6598,0.3595028796605032,0.3593513185813883,0.2811458017581085,262131.0,84300.0,72942.0
2016-06-14_09,277144,754832,423,3716,200,4339,1368,2212,1916,1579,5707,0.38759418258279305,0.3357280532679166,0.27667776414929035,262704.0,84957.0,73200.0
2016-06-14_10,277975,757582,420,3542,183,4145,1396,2149,1944,1448,5541,0.3878361306623353,0.35083919870059554,0.2613246706370691,263363.0,85520.0,73421.0
2016-06-14_11,278730,760138,406,3379,180,3965,1445,2074,1940,1396,5410,0.3833641404805915,0.3585951940850277,0.25804066543438076,264083.0,85897.0,73592.0
2016-06-14_12,279621,762971,418,3690,163,4271,1423,2077,2113,1504,5694,0.36476993326308393,0.37109237794169303,0.26413768879522304,264791.0,86466.0,73829.0
2016-06-14_13,280320,765067,312,2910,124,3346,1197,1689,1689,1165,4543,0.3717807616112701,0.3717807616112701,0.25643847677745985,265340.0,86865.0,74113.0
2016-06-14_14,280947,767100,338,2816,142,3296,1132,1676,1672,1080,4428,0.3785004516711834,0.37759710930442636,0.24390243902439024,265939.0,87265.0,74308.0
2016-06-14_15,281548,769210,320,2975,160,3455,1088,1725,1718,1100,4543,0.37970504072198985,0.37816420867268324,0.24213075060532688,266653.0,87610.0,74441.0
2016-06-14_16,282217,771456,384,3280,160,3824,1174,1859,1746,1393,4998,0.3719487795118047,0.34933973589435774,0.27871148459383754,267471.0,88031.0,74584.0
2016-06-14_17,282955,774031,390,3780,172,4342,1231,2026,2029,1518,5573,0.36353848914408754,0.36407679885160593,0.2723847120043065,268342.0,88600.0,74765.0
2016-06-14_18,283755,776809,393,4133,188,4714,1249,2058,2441,1464,5963,0.34512829112862653,0.40935770585275866,0.24551400301861478,269525.0,89217.0,74971.0
2016-06-14_19,284616,779841,474,4236,206,4916,1203,2143,2458,1518,6119,0.3502206242850139,0.4016996241215885,0.24807975159339762,270661.0,89686.0,75272.0
2016-06-14_20,285503,783161,487,4945,220,5652,1114,2214,3020,1532,6766,0.32722435707951525,0.4463493940289684,0.2264262488915164,272151.0,90202.0,75730.0
2016-06-14_21,286502,786849,604,4979,277,5860,1324,2518,2807,1859,7184,0.3505011135857461,0.3907293986636971,0.2587694877505568,273244.0,90604.0,76593.0
2016-06-14_22,287118,789685,474,3732,182,4388,890,1887,2096,1295,5278,0.3575217885562713,0.3971201212580523,0.2453580901856764,273913.0,90936.0,77179.0
2016-06-14_23,287484,791290,238,2023,63,2324,427,956,1159,636,2751,0.3475099963649582,0.4213013449654671,0.2311886586695747,274319.0,91025.0,77341.0
2016-06-15_00,287615,791827,85,697,40,822,205,347,402,278,1027,0.33787731256085685,0.3914313534566699,0.27069133398247325,274453.0,91067.0,77400.0
2016-06-15_01,287713,792092,49,406,17,472,178,260,244,146,650,0.4,0.37538461538461537,0.2246153846153846,274546.0,91093.0,77451.0
2016-06-15_02,287778,792285,22,297,11,330,111,132,166,143,441,0.29931972789115646,0.3764172335600907,0.3242630385487528,274621.0,91115.0,77471.0
2016-06-15_03,287853,792491,9,348,10,367,110,146,189,142,477,0.3060796645702306,0.39622641509433965,0.2976939203354298,274712.0,91138.0,77540.0
2016-06-15_04,287952,792848,34,611,21,666,205,291,319,261,871,0.3340987370838117,0.36624569460390355,0.29965556831228474,274851.0,91197.0,77645.0
2016-06-15_05,288195,793901,113,1448,64,1625,557,636,880,666,2182,0.2914757103574702,0.4032997250229148,0.30522456461961506,275104.0,91318.0,77782.0
2016-06-15_06,288783,796286,310,3214,132,3656,1150,1764,1682,1360,4806,0.36704119850187267,0.3499791926758219,0.28297960882230544,275669.0,91540.0,78128.0
2016-06-15_07,289653,799989,506,4721,234,5461,1811,2835,2301,2136,7272,0.38985148514851486,0.3164191419141914,0.29372937293729373,276395.0,91962.0,78406.0
2016-06-15_08,290555,803582,484,4902,257,5643,1711,2828,2495,2031,7354,0.3845526244220832,0.33927114495512645,0.27617623062279034,277615.0,92353.0,78672.0
2016-06-15_09,291626,807487,501,4770,340,5611,1856,3098,2577,1792,7467,0.4148921923128432,0.3451185214945761,0.2399892861925807,278465.0,92583.0,78984.0
2016-06-15_10,293075,812260,517,5805,294,6616,2176,3942,2682,2168,8792,0.4483621474067334,0.30505004549590536,0.24658780709736125,279546.0,92978.0,79339.0
2016-06-15_11,294759,817610,597,6658,333,7588,2526,4880,3024,2210,10114,0.48249950563575245,0.29899149693494165,0.2185089974293059,280894.0,93445.0,79853.0
2016-06-15_12,296405,822696,565,6156,343,7064,1999,4348,2752,1963,9063,0.47975284122255324,0.3036522122917356,0.21659494648571112,281992.0,93781.0,80398.0
2016-06-15_13,297700,826815,491,5048,277,5816,1622,3350,2679,1409,7438,0.4503898897553106,0.3601774670610379,0.18943264318365152,283210.0,94098.0,80908.0
2016-06-15_14,298715,830959,422,5507,222,6151,1413,2991,3187,1386,7564,0.39542570068746696,0.4213379164463247,0.18323638286620836,284685.0,94332.0,81243.0
2016-06-15_15,299763,834877,468,5064,227,5759,1377,2790,3087,1259,7136,0.39097533632286996,0.4325952914798206,0.17642937219730942,285952.0,94679.0,81517.0
2016-06-15_16,300743,838574,465,4916,225,5606,1456,2552,2903,1607,7062,0.3613707165109034,0.41107335032568676,0.2275559331634098,287111.0,95135.0,81808.0
2016-06-15_17,301778,842526,444,6121,207,6772,1788,2685,4189,1686,8560,0.31366822429906543,0.4893691588785047,0.1969626168224299,289316.0,95583.0,82173.0
2016-06-15_18,303135,847968,619,9018,252,9889,2168,3479,6161,2417,12057,0.288546072820768,0.5109894666998425,0.20046446047938957,292984.0,96180.0,82963.0
2016-06-15_19,304214,852370,492,6630,191,7313,1346,2696,4207,1756,8659,0.3113523501559072,0.4858528698464026,0.20279477999769027,295335.0,96592.0,83466.0
2016-06-15_20,305152,856244,427,5531,183,6141,1131,2462,3057,1753,7272,0.33855885588558854,0.4203795379537954,0.24106160616061606,297104.0,96986.0,83830.0
2016-06-15_21,306035,859755,418,4776,175,5369,1249,2239,2526,1853,6618,0.338319734058628,0.38168631006346326,0.2799939558779087,298319.0,97487.0,84156.0
2016-06-15_22,307189,863625,370,4687,142,5199,888,2568,1663,1856,6087,0.4218827008378512,0.2732051913914901,0.3049121077706588,299095.0,97775.0,84447.0
2016-06-15_23,307734,865306,177,2044,61,2282,529,1132,882,797,2811,0.40270366417644965,0.3137673425827108,0.2835289932408396,299487.0,97855.0,84588.0
2016-06-16_00,307956,865982,97,916,35,1048,232,475,479,326,1280,0.37109375,0.37421875,0.2546875,299762.0,97890.0,84664.0
2016-06-16_01,308089,866329,41,498,11,550,157,267,268,172,707,0.37765205091937765,0.37906647807637905,0.24328147100424327,299916.0,97914.0,84720.0
2016-06-16_02,308191,866555,30,319,5,354,77,169,123,139,431,0.39211136890951276,0.2853828306264501,0.3225058004640371,300015.0,97927.0,84762.0
2016-06-16_03,308288,866770,8,295,5,308,84,143,112,137,392,0.3647959183673469,0.2857142857142857,0.3494897959183674,300097.0,97937.0,84804.0
2016-06-16_04,308427,867171,24,587,11,622,162,282,291,211,784,0.3596938775510204,0.3711734693877551,0.26913265306122447,300265.0,97957.0,84857.0
2016-06-16_05,308766,868329,95,1572,38,1705,431,780,715,641,2136,0.3651685393258427,0.3347378277153558,0.3000936329588015,300627.0,98064.0,84949.0
2016-06-16_06,309521,870906,215,3485,116,3816,983,1899,1551,1349,4799,0.39570743904980205,0.32319233173577827,0.2811002292144197,301341.0,98419.0,85232.0
2016-06-16_07,310737,874814,312,5146,188,5646,1427,2973,2215,1885,7073,0.4203308355718931,0.313162731514209,0.2665064329138979,302253.0,99075.0,85451.0
2016-06-16_08,312179,879095,473,5170,276,5919,1687,3658,2081,1867,7606,0.4809361030765185,0.27359978963975806,0.24546410728372337,302975.0,99643.0,85664.0
2016-06-16_09,313524,883268,472,5447,223,6142,1723,3487,2259,2119,7865,0.4433566433566434,0.28722186904005087,0.2694214876033058,303977.0,100081.0,86033.0
2016-06-16_10,314801,887130,487,4886,292,5665,1732,3240,2268,1889,7397,0.438015411653373,0.3066107881573611,0.2553738001892659,304904.0,100324.0,86479.0
2016-06-16_11,315982,890962,600,5008,331,5939,1882,3297,2408,2116,7821,0.42155734560797853,0.30788901674977626,0.2705536376422452,305931.0,100707.0,86868.0
2016-06-16_12,317065,894462,515,4693,268,5476,1654,2833,2306,1991,7130,0.39733520336605893,0.32342215988779804,0.2792426367461431,306971.0,101090.0,87181.0
2016-06-16_13,317943,896957,310,3236,158,3704,1224,2211,1602,1115,4928,0.4486607142857143,0.32508116883116883,0.2262581168831169,307594.0,101384.0,87405.0
2016-06-16_14,318810,899210,260,2900,122,3282,1020,1823,1356,1123,4302,0.4237563923756392,0.31520223152022314,0.26104137610413763,308153.0,101682.0,87565.0
2016-06-16_15,319767,901881,357,3163,121,3641,1089,2138,1373,1219,4730,0.4520084566596195,0.29027484143763216,0.2577167019027484,308632.0,102059.0,87716.0
2016-06-16_16,320848,904412,357,2834,99,3290,1124,2219,1283,912,4414,0.5027186225645673,0.290666062528319,0.20661531490711374,309004.0,102357.0,87810.0
2016-06-16_17,322544,907775,309,3766,84,4159,929,3009,1240,839,5088,0.5913915094339622,0.24371069182389937,0.16489779874213836,309617.0,102522.0,87866.0
2016-06-16_18,323441,909788,237,2618,66,2921,745,1598,998,1070,3666,0.4358974358974359,0.2722313147845063,0.2918712493180578,310489.0,102665.0,87898.0
2016-06-16_19,324239,911631,223,2391,72,2686,654,1467,952,921,3340,0.43922155688622755,0.28502994011976046,0.275748502994012,311208.0,102926.0,87932.0
2016-06-16_20,325013,913389,216,2343,76,2635,572,1302,1045,860,3207,0.4059869036482694,0.32584970377299655,0.268163392578734,311932.0,103243.0,87963.0
2016-06-16_21,325685,915155,262,2205,68,2535,638,1276,921,976,3173,0.40214308225653955,0.29026158209895997,0.3075953356445005,312415.0,103523.0,87996.0
2016-06-16_22,326237,916556,184,1697,53,1934,435,1010,639,720,2369,0.4263402279442803,0.2697340650063318,0.3039257070493879,312794.0,103770.0,88019.0
2016-06-16_23,326506,917228,95,789,28,912,247,443,352,364,1159,0.3822260569456428,0.30371009490940465,0.31406384814495253,312960.0,103855.0,88036.0
2016-06-17_00,326648,917539,52,386,13,451,194,261,205,179,645,0.4046511627906977,0.3178294573643411,0.2775193798449612,313051.0,103870.0,88045.0
2016-06-17_01,326754,917757,20,288,11,319,137,167,122,167,456,0.36622807017543857,0.2675438596491228,0.36622807017543857,313118.0,103888.0,88051.0
2016-06-17_02,326873,917967,14,257,8,279,87,172,108,86,366,0.46994535519125685,0.29508196721311475,0.23497267759562843,313199.0,103898.0,88059.0
2016-06-17_03,326935,918103,10,187,2,199,67,110,83,73,266,0.41353383458646614,0.31203007518796994,0.2744360902255639,313254.0,103907.0,88066.0
2016-06-17_04,327026,918336,15,293,13,321,122,162,147,134,443,0.3656884875846501,0.33182844243792325,0.30248306997742663,313304.0,103922.0,88085.0
2016-06-17_05,327181,918802,38,676,28,742,235,410,344,223,977,0.4196519959058342,0.35209825997952915,0.22824974411463664,313526.0,103996.0,88110.0
2016-06-17_06,327517,919852,104,1461,37,1602,542,897,701,546,2144,0.4183768656716418,0.3269589552238806,0.25466417910447764,313935.0,104162.0,88143.0
2016-06-17_07,328026,921463,169,2177,55,2401,764,1424,1022,719,3165,0.44992101105845184,0.32290679304897313,0.22717219589257504,314492.0,104501.0,88176.0
2016-06-17_08,328920,923745,218,2774,80,3072,871,1443,915,1585,3943,0.36596500126807,0.2320568095358864,0.4019781891960436,314932.0,105337.0,88395.0
2016-06-17_09,329688,925744,192,2464,99,2755,810,1371,923,1271,3565,0.38457223001402524,0.25890603085554,0.3565217391304348,315346.0,105924.0,88523.0
2016-06-17_10,330342,927575,259,2203,73,2535,892,1493,883,1051,3427,0.4356580099212139,0.25765976072366503,0.30668222935512107,315686.0,106410.0,88584.0
2016-06-17_11,330893,929229,215,1963,91,2269,778,1379,712,956,3047,0.45257630456186415,0.23367246471939612,0.3137512307187397,315994.0,106803.0,88615.0
2016-06-17_12,331436,930699,202,1796,77,2075,789,1152,807,905,2864,0.4022346368715084,0.2817737430167598,0.3159916201117318,316255.0,107125.0,88658.0
2016-06-17_13,331998,932135,203,1738,77,2018,735,1151,809,793,2753,0.41808935706502,0.29386124228114785,0.28804940065383217,316620.0,107321.0,88735.0
2016-06-17_14,332551,933535,191,1721,77,1989,682,1188,725,758,2671,0.4447772369898914,0.27143391988019466,0.28378884312991387,316990.0,107579.0,88763.0
2016-06-17_15,333015,934823,182,1550,72,1804,623,1061,710,656,2427,0.43716522455706636,0.29254223320972395,0.2702925422332097,317268.0,107745.0,88819.0
2016-06-17_16,333643,936409,206,1798,80,2084,603,1070,688,929,2687,0.39821362113881653,0.25604763676963155,0.3457387420915519,317460.0,108317.0,88888.0
2016-06-17_17,334169,937781,199,1723,63,1985,558,951,767,825,2543,0.37396775462052695,0.3016122689736532,0.3244199764058199,317769.0,108741.0,88940.0
2016-06-17_18,334581,939143,249,1782,60,2091,534,1037,858,730,2625,0.39504761904761904,0.32685714285714285,0.2780952380952381,318214.0,108998.0,89009.0
2016-06-17_19,334996,940665,240,1922,77,2239,596,1076,981,778,2835,0.37954144620811286,0.346031746031746,0.2744268077601411,318590.0,109339.0,89116.0
2016-06-17_20,335519,942373,256,2009,98,2363,607,1086,968,916,2970,0.3656565656565657,0.32592592592592595,0.3084175084175084,318899.0,109635.0,89392.0
2016-06-17_21,335939,943962,225,2021,77,2323,561,1017,1052,815,2884,0.3526352288488211,0.3647711511789182,0.28259361997226073,319243.0,109922.0,89542.0
2016-06-17_22,336299,945279,188,1629,54,1871,488,870,817,672,2359,0.36880033912674864,0.34633319203052143,0.28486646884273,319483.0,110182.0,89633.0
2016-06-17_23,336507,946128,131,1157,44,1332,348,477,566,637,1680,0.2839285714285714,0.33690476190476193,0.37916666666666665,319705.0,110341.0,89743.0
2016-06-18_00,336611,946534,69,560,25,654,213,265,353,249,867,0.30565167243367936,0.4071510957324106,0.28719723183391005,319869.0,110396.0,89767.0
2016-06-18_01,336681,946783,29,340,16,385,120,168,193,144,505,0.3326732673267327,0.3821782178217822,0.2851485148514851,319959.0,110427.0,89792.0
2016-06-18_02,336717,946918,21,202,20,243,103,113,144,89,346,0.3265895953757225,0.4161849710982659,0.25722543352601157,320039.0,110445.0,89805.0
2016-06-18_03,336758,947067,18,208,21,247,68,97,127,91,315,0.30793650793650795,0.4031746031746032,0.28888888888888886,320095.0,110464.0,89819.0
2016-06-18_04,336815,947286,16,284,23,323,99,149,154,119,422,0.35308056872037913,0.36492890995260663,0.28199052132701424,320138.0,110490.0,89874.0
2016-06-18_05,336916,947738,35,598,32,665,190,271,335,249,855,0.3169590643274854,0.391812865497076,0.2912280701754386,320249.0,110566.0,89946.0
2016-06-18_06,337121,948625,86,1228,44,1358,444,661,638,503,1802,0.3668146503884573,0.35405105438401774,0.279134295227525,320416.0,110804.0,90007.0
2016-06-18_07,337554,950320,205,2207,86,2498,739,1220,1146,871,3237,0.37689218412109976,0.3540315106580167,0.26907630522088355,320807.0,111112.0,90217.0
2016-06-18_08,338016,952083,315,2257,110,2682,810,1450,1153,889,3492,0.4152348224513173,0.3301832760595647,0.25458190148911797,321185.0,111377.0,90380.0
2016-06-18_09,338507,953899,292,2253,142,2687,888,1427,1162,986,3575,0.39916083916083916,0.32503496503496504,0.2758041958041958,321620.0,111537.0,90553.0
2016-06-18_10,339039,956092,360,2490,132,2982,824,1569,1445,792,3806,0.4122438255386232,0.37966368891224384,0.20809248554913296,321917.0,111653.0,90649.0
2016-06-18_11,339564,958119,319,2409,134,2862,798,1576,1356,728,3660,0.4306010928961749,0.3704918032786885,0.1989071038251366,322290.0,111726.0,90763.0
2016-06-18_12,339666,958535,80,562,33,675,193,306,409,153,868,0.35253456221198154,0.47119815668202764,0.17626728110599077,322449.0,111741.0,90783.0
2016-06-18_13,339666,958535,80,562,33,675,193,306,409,153,868,0.35253456221198154,0.47119815668202764,0.17626728110599077,322449.0,111741.0,90783.0
2016-06-18_14,339809,959052,95,655,22,772,219,402,412,177,991,0.4056508577194753,0.4157416750756811,0.17860746720484358,322594.0,111775.0,90810.0
2016-06-18_15,340262,960636,266,2295,89,2650,644,1218,1388,688,3294,0.3697632058287796,0.42137219186399516,0.20886460230722526,323174.0,111903.0,91033.0
2016-06-18_16,340648,962203,243,2411,104,2758,660,1133,1553,732,3418,0.331480397893505,0.4543592744294909,0.2141603276770041,323948.0,111976.0,91221.0
2016-06-18_17,341012,963970,246,2650,95,2991,583,1011,1678,885,3574,0.28287632904308896,0.46950195858981536,0.24762171236709568,324614.0,112058.0,91393.0
2016-06-18_18,341409,965788,257,2335,98,2690,651,1083,1329,929,3341,0.3241544447770129,0.39778509428314873,0.2780604609398384,325023.0,112305.0,91508.0
2016-06-18_19,341862,967629,230,2384,66,2680,590,1020,1325,925,3270,0.3119266055045872,0.40519877675840976,0.28287461773700306,325459.0,112700.0,91626.0
2016-06-18_20,342385,969607,258,2588,96,2942,604,1107,1436,1003,3546,0.31218274111675126,0.40496333897349124,0.2828539199097575,325988.0,113108.0,91725.0
2016-06-18_21,342863,972110,288,3131,137,3556,621,1808,1472,897,4177,0.43284654057936317,0.3524060330380656,0.21474742638257122,326545.0,113359.0,92021.0
2016-06-18_22,343221,974367,239,2782,113,3134,548,1333,1429,920,3682,0.36203150461705597,0.3881042911461162,0.2498642042368278,326964.0,113514.0,92309.0
2016-06-18_23,343473,975647,158,1668,55,1881,379,745,931,584,2260,0.32964601769911506,0.4119469026548673,0.2584070796460177,327287.0,113611.0,92424.0
2016-06-19_00,343613,976276,85,843,18,946,244,418,494,278,1190,0.35126050420168065,0.4151260504201681,0.23361344537815126,327488.0,113662.0,92461.0
2016-06-19_01,343707,976653,47,553,9,609,151,263,348,149,760,0.3460526315789474,0.45789473684210524,0.19605263157894737,327619.0,113693.0,92489.0
2016-06-19_02,343762,976871,28,387,9,424,92,140,283,93,516,0.2713178294573643,0.5484496124031008,0.18023255813953487,327754.0,113711.0,92509.0
2016-06-19_03,343837,977072,13,271,9,293,72,156,136,73,365,0.4273972602739726,0.3726027397260274,0.2,327809.0,113727.0,92539.0
2016-06-19_04,343923,977369,19,459,11,489,106,241,221,133,595,0.4050420168067227,0.37142857142857144,0.2235294117647059,327910.0,113746.0,92624.0
2016-06-19_05,344019,977850,50,760,19,829,193,354,450,218,1022,0.34637964774951074,0.44031311154598823,0.21330724070450097,328175.0,113789.0,92678.0
2016-06-19_06,344227,978958,100,1727,45,1872,433,767,984,554,2305,0.33275488069414316,0.42689804772234274,0.2403470715835141,328695.0,113884.0,92820.0
2016-06-19_07,344687,981246,207,3307,110,3624,772,1622,1705,1069,4396,0.3689717925386715,0.387852593266606,0.24317561419472247,329357.0,114153.0,93179.0
2016-06-19_08,345325,984421,367,4246,167,4780,1117,2199,2099,1599,5897,0.3729014753264372,0.35594370018653554,0.2711548244870273,330138.0,114610.0,93740.0
2016-06-19_09,345935,987616,476,4182,197,4855,1242,2266,2134,1697,6097,0.37165819255371496,0.3500082007544694,0.27833360669181567,330830.0,114886.0,94224.0
2016-06-19_10,346563,990504,441,4364,183,4988,1216,2098,2496,1610,6204,0.33816892327530623,0.402321083172147,0.2595099935525467,332031.0,115239.0,94596.0
2016-06-19_11,347213,993542,479,5169,202,5850,1174,2098,3448,1478,7024,0.29869020501138954,0.4908883826879271,0.21042141230068337,333825.0,115662.0,95090.0
2016-06-19_12,347758,996068,388,4372,147,4907,970,2026,2690,1161,5877,0.3447337076739833,0.4577165220350519,0.19754977029096477,335346.0,116098.0,95523.0
2016-06-19_13,348288,998458,380,3747,149,4276,865,1726,2225,1190,5141,0.3357323477922583,0.4327951760357907,0.231472476171951,336578.0,116402.0,95824.0
2016-06-19_14,348807,1000674,354,3613,166,4133,783,1646,2124,1146,4916,0.33482506102522375,0.4320585842148088,0.23311635475996745,337829.0,116670.0,96187.0
2016-06-19_15,349316,1002890,310,3774,156,4240,838,1481,2468,1129,5078,0.2916502560063017,0.48601811736904293,0.2223316266246554,339166.0,116895.0,96517.0
2016-06-19_16,349808,1005204,348,3919,125,4392,838,1701,2513,1016,5230,0.3252390057361377,0.48049713193116633,0.194263862332696,340528.0,117119.0,96889.0
2016-06-19_17,350629,1008465,350,5466,161,5977,1266,2033,3417,1793,7243,0.2806847991163882,0.4717658428827834,0.2475493580008284,342430.0,117429.0,97474.0
2016-06-19_18,351901,1014248,761,9983,281,11025,2725,3657,7381,2712,13750,0.26596363636363635,0.5368,0.19723636363636363,346499.0,117768.0,98891.0
2016-06-19_19,353093,1019203,509,7629,221,8359,1138,2621,4424,2452,9497,0.2759818890175845,0.4658313151521533,0.25818679583026216,348996.0,118345.0,100191.0
2016-06-19_20,354046,1023327,445,6422,209,7076,1038,2315,3826,1973,8114,0.28530934187823515,0.4715306877002711,0.2431599704214937,351270.0,118823.0,100936.0
2016-06-19_21,354850,1027158,479,5920,222,6621,1102,2077,3647,1999,7723,0.268936941603004,0.4722258189822608,0.2588372394147352,353348.0,119140.0,101492.0
2016-06-19_22,355420,1029842,365,4243,165,4773,819,1553,2727,1312,5592,0.2777181688125894,0.4876609442060086,0.23462088698140202,354893.0,119323.0,101995.0
2016-06-19_23,355753,1031263,189,2055,71,2315,465,773,1167,840,2780,0.2780575539568345,0.4197841726618705,0.302158273381295,355482.0,119486.0,102180.0
2016-06-20_00,355857,1031778,82,832,42,956,230,319,593,274,1186,0.26897133220910624,0.5,0.23102866779089376,355763.0,119527.0,102258.0
2016-06-20_01,355971,1032139,50,605,19,674,133,230,369,208,807,0.2850061957868649,0.45724907063197023,0.2577447335811648,355971.0,119555.0,102340.0
2016-06-20_02,356046,1032369,22,384,5,411,109,172,248,100,520,0.33076923076923076,0.47692307692307695,0.19230769230769232,356097.0,119568.0,102376.0
2016-06-20_03,356114,1032572,7,330,2,339,97,158,176,102,436,0.3623853211009174,0.4036697247706422,0.23394495412844038,356188.0,119586.0,102406.0
2016-06-20_04,356201,1032873,22,478,15,515,176,242,270,179,691,0.35021707670043417,0.3907380607814761,0.2590448625180897,356312.0,119607.0,102460.0
2016-06-20_05,356417,1033800,101,1442,49,1592,502,667,846,581,2094,0.31852913085004775,0.4040114613180516,0.27745940783190065,356763.0,119696.0,102691.0
2016-06-20_06,356823,1035781,262,3064,125,3451,1058,1653,1785,1071,4509,0.3666001330671989,0.3958749168330007,0.2375249500998004,357677.0,120100.0,102994.0
2016-06-20_07,357596,1038855,377,4482,198,5057,1654,2520,2478,1713,6711,0.3755029056772463,0.36924452391595886,0.25525257040679483,358801.0,120794.0,103405.0
2016-06-20_08,358618,1042587,533,4984,224,5741,1871,3261,2423,1928,7612,0.4284025223331582,0.31831318970047295,0.25328428796636887,359826.0,121238.0,103807.0
2016-06-20_09,359604,1046147,463,4823,207,5493,1934,2949,2336,2142,7427,0.3970647637000135,0.31452807324626364,0.2884071630537229,360764.0,121736.0,104058.0
2016-06-20_10,360577,1049634,481,4763,218,5462,2028,3221,2377,1892,7490,0.4300400534045394,0.3173564753004005,0.25260347129506006,361815.0,122018.0,104436.0
2016-06-20_11,361673,1053103,488,5254,240,5982,2025,2998,3242,1767,8007,0.374422380417135,0.40489571624828274,0.22068190333458224,363337.0,122372.0,104808.0
2016-06-20_12,362948,1056762,477,5370,244,6091,2119,3061,3417,1732,8210,0.3728380024360536,0.4161997563946407,0.21096224116930573,364889.0,122787.0,105061.0
2016-06-20_13,364084,1059803,382,4439,210,5031,1764,2578,2732,1485,6795,0.37939661515820455,0.40206033848417955,0.2185430463576159,366133.0,123045.0,105296.0
2016-06-20_14,365112,1062811,377,4388,180,4945,1610,2457,2532,1566,6555,0.3748283752860412,0.3862700228832952,0.2389016018306636,367324.0,123414.0,105522.0
2016-06-20_15,366230,1065874,427,4352,202,4981,1699,2504,2521,1655,6680,0.37485029940119763,0.37739520958083833,0.24775449101796407,368444.0,123686.0,105789.0
2016-06-20_16,367406,1069843,483,5617,216,6316,1760,3288,3097,1691,8076,0.40713224368499257,0.38348192174343737,0.2093858345715701,369870.0,123985.0,106223.0
2016-06-20_17,368688,1073979,560,6703,233,7496,2167,3695,3860,2108,9663,0.38238642243609644,0.3994618648452861,0.2181517127186174,372200.0,124367.0,106680.0
2016-06-20_18,369946,1078204,583,6511,217,7311,2116,3638,3484,2305,9427,0.38591280364909303,0.3695767476397581,0.24451044871114883,374166.0,124770.0,107247.0
2016-06-20_19,371003,1081867,463,5578,214,6255,1493,2753,3180,1815,7748,0.35531750129065565,0.4104284976768198,0.23425400103252453,375748.0,125021.0,107716.0
2016-06-20_20,371995,1085435,387,5582,186,6155,1381,2542,3322,1672,7536,0.33731422505307856,0.44081740976645434,0.2218683651804671,377364.0,125311.0,108411.0
2016-06-20_21,373241,1090041,528,6832,250,7610,1785,3336,3865,2194,9395,0.3550824906865354,0.41138903672166044,0.23352847259180415,379224.0,125769.0,109092.0
2016-06-20_22,373943,1093171,360,4704,192,5256,1129,2218,2821,1346,6385,0.3473766640563821,0.4418167580266249,0.21080657791699295,380752.0,125980.0,109465.0
2016-06-20_23,374325,1094687,168,2399,98,2665,647,1169,1384,759,3312,0.35295893719806765,0.4178743961352657,0.22916666666666666,381508.0,126161.0,109698.0
2016-06-21_00,374506,1095399,73,1137,31,1241,335,528,693,355,1576,0.3350253807106599,0.4397208121827411,0.22525380710659898,381846.0,126234.0,109790.0
2016-06-21_01,374611,1095741,31,578,15,624,222,281,387,178,846,0.3321513002364066,0.4574468085106383,0.21040189125295508,382037.0,126258.0,109818.0
2016-06-21_02,374705,1095997,29,407,10,446,132,215,248,115,578,0.3719723183391003,0.4290657439446367,0.19896193771626297,382182.0,126273.0,109847.0
2016-06-21_03,374781,1096245,19,449,8,476,161,181,344,112,637,0.28414442700156983,0.5400313971742543,0.17582417582417584,382331.0,126297.0,109871.0
2016-06-21_04,374920,1096785,34,899,21,954,204,357,540,261,1158,0.3082901554404145,0.46632124352331605,0.22538860103626943,382624.0,126342.0,109960.0
2016-06-21_05,375256,1098075,103,2014,50,2167,599,993,1130,643,2766,0.35900216919739697,0.40853217642805495,0.23246565437454808,383178.0,126436.0,110253.0
2016-06-21_06,375917,1100484,274,3542,152,3968,1325,1960,1866,1467,5293,0.3703003967504251,0.35254109200831285,0.27715851124126206,383994.0,126797.0,110581.0
2016-06-21_07,376998,1104338,409,5792,265,6466,2087,3077,3148,2328,8553,0.35975681047585645,0.368057991348065,0.27218519817607856,385448.0,127322.0,111094.0
2016-06-21_08,378829,1109287,502,6433,317,7252,2485,4070,3036,2631,9737,0.41799322173153947,0.3118003491835267,0.27020642908493375,386483.0,127961.0,111636.0
2016-06-21_09,381307,1114901,514,7180,309,8003,2346,5202,2695,2452,10349,0.5026572615711663,0.260411633974297,0.23693110445453666,387651.0,128626.0,112099.0
2016-06-21_10,383370,1119787,556,6527,323,7406,2210,4375,2688,2553,9616,0.4549708818635607,0.2795341098169717,0.26549500831946754,388909.0,129349.0,112682.0
2016-06-21_11,385377,1124842,517,6719,326,7562,2368,4388,3124,2418,9930,0.4418932527693857,0.31460221550855993,0.24350453172205438,390129.0,130070.0,113296.0
2016-06-21_12,387199,1129256,570,6059,316,6945,2497,4184,2982,2276,9442,0.4431264562592671,0.3158229188731201,0.2410506248676128,391522.0,130734.0,113773.0
2016-06-21_13,388911,1133540,604,5779,300,6683,2084,3875,2979,1913,8767,0.4419984031025436,0.3397969658948329,0.21820463100262347,392688.0,131240.0,114331.0
2016-06-21_14,390426,1137272,503,5103,257,5863,1953,3309,2651,1856,7816,0.4233623336745138,0.3391760491299898,0.2374616171954964,393617.0,131659.0,114856.0
2016-06-21_15,391916,1141164,474,5337,295,6106,1973,3331,2515,2233,8079,0.4123035029087758,0.3113009035771754,0.27639559351404874,394693.0,132163.0,115297.0
2016-06-21_16,393301,1145276,553,5543,260,6356,2074,3416,2751,2263,8430,0.40521945432977463,0.32633451957295373,0.26844602609727164,395618.0,132760.0,115861.0
2016-06-21_17,394907,1150311,602,6988,320,7910,2137,4265,3329,2453,10047,0.4245048273116353,0.33134268936000794,0.24415248332835673,396939.0,133416.0,116579.0
2016-06-21_18,396737,1155903,594,8781,333,9708,2305,4701,4726,2586,12013,0.3913260634312828,0.3934071422625489,0.21526679430616832,399559.0,134111.0,117235.0
2016-06-21_19,400108,1164691,1060,13505,401,14966,6896,8333,9033,4496,21862,0.38116366297685483,0.41318269142804864,0.20565364559509652,403345.0,136012.0,118645.0
2016-06-21_20,404296,1176436,1510,15811,553,17874,7263,9759,9633,5745,25137,0.3882324859768469,0.3832199546485261,0.22854755937462704,406757.0,138342.0,120452.0
2016-06-21_21,406955,1185924,1094,12934,493,14521,3121,6573,6844,4225,17642,0.37257680535086724,0.38793787552431697,0.23948531912481577,409742.0,139747.0,122068.0
2016-06-21_22,408804,1192014,711,7999,329,9039,1702,4177,4029,2535,10741,0.38888371659994414,0.37510473885113116,0.23601154454892467,411401.0,141082.0,122839.0
2016-06-21_23,409605,1194689,277,3610,149,4036,852,1874,1972,1042,4888,0.38338788870703766,0.4034369885433715,0.21317512274959083,412221.0,141488.0,123278.0
2016-06-22_00,410062,1195931,124,1696,61,1881,455,911,935,490,2336,0.3899828767123288,0.4002568493150685,0.20976027397260275,412591.0,141630.0,123491.0
2016-06-22_01,410323,1196552,76,784,19,879,282,491,462,208,1161,0.42291128337639966,0.3979328165374677,0.17915590008613264,412743.0,141741.0,123587.0
2016-06-22_02,410538,1196991,43,573,11,627,157,336,307,141,784,0.42857142857142855,0.39158163265306123,0.1798469387755102,412870.0,141804.0,123644.0
2016-06-22_03,410709,1197383,36,544,8,588,123,309,245,157,711,0.4345991561181435,0.34458509142053445,0.22081575246132207,412970.0,141847.0,123696.0
2016-06-22_04,410919,1197947,60,927,24,1011,293,459,550,295,1304,0.35199386503067487,0.4217791411042945,0.22622699386503067,413227.0,141962.0,123785.0
2016-06-22_05,411692,1199822,158,2635,65,2858,743,1599,1273,729,3601,0.44404332129963897,0.35351291307970006,0.20244376562066094,413806.0,142231.0,123977.0
2016-06-22_06,413023,1204032,409,5859,218,6486,1910,3485,3112,1799,8396,0.41507860886136255,0.37065269175798,0.21426869938065746,415121.0,142913.0,124426.0
2016-06-22_07,415189,1210500,543,8462,310,9315,2659,4691,3688,3595,11974,0.39176549189911475,0.30800066811424753,0.3002338399866377,416668.0,144372.0,125017.0
2016-06-22_08,417697,1217508,677,9002,372,10051,3157,5936,3591,3681,13208,0.4494245911568746,0.27188067837674135,0.278694730466384,417967.0,145760.0,125833.0
2016-06-22_09,420401,1224555,760,9063,395,10218,3197,5823,3793,3799,13415,0.4340663436451733,0.2827431979127842,0.2831904584420425,419398.0,147071.0,126859.0
2016-06-22_10,422995,1231164,774,8484,391,9649,3319,5774,3499,3695,12968,0.44524984577421345,0.26981801357186924,0.2849321406539173,420859.0,147873.0,127759.0
2016-06-22_11,425571,1237533,632,8858,360,9850,3412,5549,4490,3223,13262,0.4184135122907555,0.33856130297089426,0.24302518473835016,422918.0,148509.0,128391.0
2016-06-22_12,428300,1244456,697,9419,371,10487,3462,5870,4718,3361,13949,0.42081869668076566,0.3382321313355796,0.24094917198365473,424806.0,149420.0,129173.0
2016-06-22_13,430817,1250968,682,8541,391,9614,3136,5696,3823,3231,12750,0.4467450980392157,0.29984313725490197,0.25341176470588234,426293.0,150177.0,130087.0
2016-06-22_14,433177,1257333,736,8218,388,9342,3116,5133,4210,3115,12458,0.41202440199068874,0.3379354631562049,0.25004013485310644,427660.0,150642.0,131038.0
2016-06-22_15,436124,1264767,726,9581,435,10742,3279,5677,4509,3835,14021,0.40489266100848725,0.3215890450039227,0.27351829398759003,429358.0,151342.0,132040.0
2016-06-22_16,438989,1272260,719,9561,448,10728,3409,5823,4487,3827,14137,0.41189785668812334,0.3173940722925656,0.27070807101931105,430767.0,152228.0,133169.0
2016-06-22_17,441767,1279618,760,9658,418,10836,3534,5601,4754,4015,14370,0.3897703549060543,0.33082811412665275,0.279401530967293,432416.0,152974.0,134077.0
2016-06-22_18,445109,1287633,890,10280,440,11610,4181,6090,5497,4204,15791,0.3856627192704705,0.3481096827306694,0.2662275979988601,434267.0,153821.0,134961.0
2016-06-22_19,448222,1296019,874,11352,435,12661,3771,6073,6138,4221,16432,0.36958373904576436,0.373539435248296,0.2568768257059396,436929.0,154505.0,135781.0
2016-06-22_20,451530,1304061,927,11788,414,13129,4603,6366,7056,4310,17732,0.35901195578614936,0.3979246559891721,0.24306338822467854,440313.0,155315.0,136571.0
2016-06-22_21,456691,1314830,1070,14885,544,16499,5554,8617,7633,5803,22053,0.39074048882238244,0.34612070920056226,0.2631388019770553,443826.0,156438.0,138161.0
2016-06-22_22,460124,1322689,783,10482,364,11629,3557,5748,5332,4106,15186,0.3785065191623864,0.3511128671144475,0.2703806137231661,446140.0,157172.0,139429.0
2016-06-22_23,462058,1326803,491,5751,190,6432,2005,3124,3188,2125,8437,0.37027379400260757,0.3778594287068863,0.2518667772905061,447532.0,157488.0,139992.0
